action movie	['action film', 'action flick', 'action picture', 'action pic', 'activity movie', 'process movie', 'sue movie']
adjustment process	['registration process', 'modification process', 'fitting process', 'accommodation process', 'adaptation process', 'adjustment procedure', 'adjustment work']
advertising contract	['advertising press', 'advertising get', 'advertising sign', 'advertising take', 'advertising signup', 'advertisement contract', 'ad contract']
advertising designer	['advertising architect', 'ad designer', 'advertising decorator', 'advert designer', 'advertisement designer', 'advertise designer', 'push designer']
advertising purpose	['advertising design', 'advertising use', 'advertising role', 'advertising function', 'advertisement purpose', 'ad purpose', 'advertising aim']
age limit	['age set', 'years limit', 'age limitation', 'age restrict', 'age boundary', 'age determine', 'age define']
air bag	['air base', 'air pocket', 'air dish', 'line bag', 'aviation bag', 'beam bag', 'air grip']
air mail	['send mail', 'air post', 'line mail', 'air send', 'broadcast mail', 'transmit mail', 'strain mail']
alcohol bottle	['inebriant bottle', 'intoxicant bottle', 'alcoholicdrink bottle', 'alcoholicbeverage bottle', 'alcohol bottleful', 'alcohol nursingbottle', 'alcohol feedingbottle']
animal anatomy	['animal form', 'animal flesh', 'animal figure', 'animal shape', 'animal frame', 'animal build', 'animal physique']
animal brain	['animal head', 'animal mind', 'animal genius', 'animal mastermind', 'creature brain', 'animal nous', 'animal mentality']
animal matter	['animal issue', 'animal thing', 'animal subject', 'brute matter', 'animal topic', 'animal weigh', 'animal affair']
animal matter	['animal issue', 'animal thing', 'animal subject', 'brute matter', 'animal topic', 'animal weigh', 'animal affair']
ankle injury	['ankle trauma', 'ankle hurt', 'ankle wound', 'ankle harm', 'anklejoint injury', 'articulatiotalocruralis injury', 'mortisejoint injury']
approval rating	['approval rate', 'approval order', 'approval value', 'approval rank', 'approval place', 'approval shop', 'approval grade']
area director	['area manager', 'country director', 'field director', 'region director', 'arena director', 'domain director', 'area conductor']
arm wrestling	['arm wrestle', 'arm twist', 'sleeve wrestling', 'arm worm', 'arm grappling', 'arm wriggle', 'arm squirm']
army camp	['Army camp', 'USA camp', 'army tent', 'army pack', 'army encampment', 'army cantonment', 'army encamp']
art collection	['art collecting', 'art assemblage', 'graphics collection', 'artwork collection', 'art appeal', 'artistry collection', 'fineart collection']
art form	['art work', 'art class', 'art make', 'art spring', 'art course', 'art frame', 'art figure']
art group	['graphics group', 'art radical', 'artwork group', 'artistry group', 'art grouping', 'fineart group', 'prowess group']
attack damage	['fire damage', 'blast damage', 'flak damage', 'attack wrong', 'attack price', 'round damage', 'attack hurt']
back door	['rear door', 'second door', 'cover door', 'support door', 'game door', 'back doorway', 'back threshold']
back door	['rear door', 'second door', 'cover door', 'support door', 'game door', 'back doorway', 'back threshold']
back pain	['spine pain', 'support pain', 'back hurt', 'back trouble', 'back hurting', 'cover pain', 'second pain']
background check	['background see', 'setting check', 'ground check', 'background verification', 'background tab', 'background match', 'background learn']
background color	['background colour', 'ground color', 'setting color', 'desktop color', 'background coloring', 'backdrop color', 'scope color']
backup anchor	['support anchor', 'substitute anchor', 'backup ground', 'relief anchor', 'reliever anchor', 'backup backbone', 'backing anchor']
backup file	['support file', 'backup register', 'backing file', 'backup datafile', 'backup singlefile', 'substitute file', 'accompaniment file']
backup operation	['backup process', 'support operation', 'relief operation', 'backup performance', 'backup procedure', 'substitute operation', 'backing operation']
bank account	['deposit account', 'trust account', 'bank report', 'bank bill', 'bank history', 'cant account', 'bank story']
bank building	['trust building', 'bank make', 'bank construction', 'bank build', 'bank progress', 'deposit building', 'bank establish']
bank building	['trust building', 'bank make', 'bank construction', 'bank build', 'bank progress', 'deposit building', 'bank establish']
bass player	['bass musician', 'deep player', 'bass instrumentalist', 'bass participant', 'bassvoice player', 'basso player', 'basspart player']
bass player	['bass musician', 'deep player', 'bass instrumentalist', 'bass participant', 'bassvoice player', 'basso player', 'basspart player']
belief system	['opinion system', 'impression system', 'feeling system', 'notion system', 'belief organization', 'belief scheme', 'belief organisation']
bird species	['bird specie', 'fowl species', 'raspberry species', 'chick species', 'bird mintage', 'shuttlecock species', 'birdwatch species']
birth certificate	['have certificate', 'birth certification', 'deliver certificate', 'bear certificate', 'birth security', 'nativity certificate', 'birth credentials']
birth name	['have name', 'bear name', 'birth make', 'birth list', 'birth discover', 'birth call', 'birth figure']
birth place	['birth rate', 'birth order', 'birth home', 'have place', 'birth situation', 'birth site', 'birth grade']
blood cell	['line cell', 'pedigree cell', 'stock cell', 'lineage cell', 'origin cell', 'descent cell', 'rip cell']
blood pressure	['line pressure', 'blood press', 'stock pressure', 'blood force', 'blood pressing', 'descent pressure', 'lineage pressure']
blood sugar	['stock sugar', 'line sugar', 'blood bread', 'origin sugar', 'blood carbohydrate', 'stemma sugar', 'rip sugar']
blood test	['line test', 'blood run', 'rake test', 'blood quiz', 'ancestry test', 'stock test', 'parentage test']
board game	['card game', 'room game', 'board back', 'table game', 'panel game', 'board plot', 'board gamey']
body fat	['body fatness', 'body rich', 'trunk fat', 'body plump', 'body fatty', 'body juicy', 'consistency fat']
body parts	['body part', 'body section', 'body function', 'body start', 'body region', 'body break', 'body portion']
body parts	['body part', 'body section', 'body function', 'body start', 'body region', 'body break', 'body portion']
boiling process	['boiling serve', 'simmering process', 'boil process', 'boiling action', 'churn process', 'stewing process', 'boiling procedure']
bone problem	['os problem', 'drum problem', 'bone trouble', 'pearl problem', 'ivory problem', 'mugup problem', 'cram problem']
book character	['book case', 'book part', 'book type', 'Book character', 'book reference', 'Bible character', 'Word character']
brain death	['brain Death', 'mind death', 'brain last', 'head death', 'brain end', 'brain dying', 'brain destruction']
brain volume	['brain book', 'head volume', 'genius volume', 'brain mass', 'mind volume', 'psyche volume', 'Einstein volume']
bridge structure	['bridge construction', 'span structure', 'bridgeover structure', 'bridgedeck structure', 'bridgecircuit structure', 'nosepiece structure', 'bridgework structure']
bullet hole	['smoke hole', 'bullet trap', 'heater hole', 'bullet hollow', 'bullet fix', 'slug hole', 'bullettrain hole']
bullet proof	['smoke proof', 'slug proof', 'heater proof', 'bullettrain proof', 'hummer proof', 'fastball proof', 'bullet cogentevidence']
bullet proof	['smoke proof', 'slug proof', 'heater proof', 'bullettrain proof', 'hummer proof', 'fastball proof', 'bullet cogentevidence']
bulletin board	['bulletin table', 'bulletin panel', 'bulletin room', 'bulletin card', 'bulletin plank', 'bulletin circuitcard', 'bulletin gameboard']
bus stop	['bus bar', 'coach stop', 'bus check', 'bus end', 'bus layover', 'bus stay', 'bus point']
bus stop	['bus bar', 'coach stop', 'bus check', 'bus end', 'bus layover', 'bus stay', 'bus point']
bus system	['bus scheme', 'coach system', 'busbar system', 'bus arrangement', 'bus organization', 'omnibus system', 'heap system']
bus system	['bus scheme', 'coach system', 'busbar system', 'bus arrangement', 'bus organization', 'omnibus system', 'heap system']
bus terminal	['bus depot', 'bus terminus', 'bus last', 'bus end', 'coach terminal', 'bus final', 'bus pole']
bus travel	['coach travel', 'bus trip', 'bus journey', 'bus go', 'bus traveling', 'motorcoach travel', 'bus travelling']
business activity	['business action', 'line activity', 'job activity', 'occupation activity', 'concern activity', 'clientele activity', 'stagebusiness activity']
business associate	['business link', 'business affiliate', 'business connect', 'job associate', 'business companion', 'business fellow', 'line associate']
business contact	['business link', 'job contact', 'line contact', 'business meet', 'clientele contact', 'business reach', 'patronage contact']
business law	['job law', 'business police', 'line law', 'occupation law', 'concern law', 'clientele law', 'business jurisprudence']
business leader	['line leader', 'job leader', 'occupation leader', 'clientele leader', 'stagebusiness leader', 'commercialenterprise leader', 'businessconcern leader']
business man	['business world', 'business human', 'business Man', 'job man', 'line man', 'business humans', 'business piece']
business news	['business intelligence', 'job news', 'line news', 'business word', 'concern news', 'occupation news', 'clientele news']
business plan	['business program', 'business design', 'business project', 'job plan', 'line plan', 'business programme', 'occupation plan']
business representative	['business voice', 'business illustration', 'business example', 'line representative', 'business interpreter', 'business congresswoman', 'business congressman']
business trip	['business travel', 'line trip', 'business slip', 'business activate', 'job trip', 'business trigger', 'business spark']
business trip	['business travel', 'line trip', 'business slip', 'business activate', 'job trip', 'business trigger', 'business spark']
cable car	['line car', 'cable machine', 'wire car', 'cable auto', 'telegraph car', 'cable gondola', 'cable automobile']
calendar year	['calendar class', 'calendar yr', 'calendar twelvemonth']
calorie intake	['Calorie intake', 'calorie consumption', 'kilocalorie intake', 'calorie ingestion', 'calorie uptake', 'calorie inlet', 'nutritionistscalorie intake']
cancer screening	['Cancer screening', 'cancer test', 'cancer cover', 'cancer screen', 'cancer showing', 'cancer viewing', 'cancer sort']
cancer specialist	['Cancer specialist', 'Crab specialist', 'genusCancer specialist', 'CancertheCrab specialist', 'malignantneoplasticdisease specialist', 'cancer medicalspecialist', 'cancer specializer']
car chase	['car Chase', 'car track', 'car dog', 'car tag', 'car following', 'car pursuit', 'car tail']
car door	['auto door', 'machine door', 'railcar door', 'automobile door', 'car threshold', 'gondola door', 'cablecar door']
car key	['car Key', 'car paint', 'car name', 'auto key', 'car central', 'machine key', 'car discover']
car key	['car Key', 'car paint', 'car name', 'auto key', 'car central', 'machine key', 'car discover']
car wash	['machine wash', 'car washing', 'car race', 'auto wash', 'car lap', 'automobile wash', 'car laundry']
card game	['board game', 'card back', 'menu game', 'bill game', 'card biz', 'posting game', 'notice game']
card reader	['board reader', 'poster reader', 'posting reader', 'bill reader', 'card referee', 'menu reader', 'card subscriber']
cargo capacity	['load capacity', 'loading capacity', 'payload capacity', 'freight capacity', 'cargo capability', 'lading capacity', 'cargo content']
cargo facility	['freight facility', 'loading facility', 'load facility', 'shipment facility', 'cargo installation', 'payload facility', 'cargo readiness']
cargo shipping	['freight shipping', 'cargo ship', 'cargo transport', 'shipment shipping', 'cargo transportation', 'loading shipping', 'load shipping']
cargo transport	['cargo ship', 'cargo shipping', 'freight transport', 'cargo transportation', 'load transport', 'cargo transfer', 'loading transport']
carnival crowd	['fair crowd', 'carnival crew', 'circus crowd', 'funfair crowd', 'carnival bunch', 'carnival push', 'carnival herd']
carnival people	['fair people', 'circus people', 'carnival mass', 'funfair people', 'carnival masses', 'carnival hoipolloi', 'carnival citizenry']
case study	['case report', 'character study', 'case read', 'case work', 'case take', 'case consider', 'case learn']
case study	['case report', 'character study', 'case read', 'case work', 'case take', 'case consider', 'case learn']
cash flow	['Cash flow', 'cash flowing', 'cash course', 'cash current', 'cash stream', 'cash run', 'cash feed']
cash machine	['Cash machine', 'cash car', 'cash auto', 'cash automobile', 'JohnnyCash machine', 'cashin machine', 'immediatepayment machine']
cat flap	['CAT flap', 'cat flaps', 'cat beat', 'cat wave', 'cat roll', 'chuck flap', 'hombre flap']
cell types	['cell type', 'cell case', 'cell character', 'cellphone types', 'cadre types', 'cellularphone types', 'cubicle types']
center row	['center course', 'middle row', 'sum row', 'centre row', 'plaza row', 'focus row', 'center words']
charity event	['charity case', 'charity issue', 'charity result', 'charity effect', 'Polymoniumcaeruleumvanbruntiae event', 'Polemoniumvanbruntiae event', 'Greekvalerian event']
chess talent	['chess gift', 'cheat talent', 'Bromussecalinus talent', 'chessgame talent', 'chess endowment', 'chess naturalendowment']
chicken breast	['yellow breast', 'poulet breast', 'chicken boob', 'chicken chest', 'chicken front', 'chicken summit', 'chicken knocker']
child abuse	['child maltreatment', 'child step', 'minor abuse', 'child maltreat', 'baby abuse', 'kid abuse', 'child shout']
child care	['baby care', 'child like', 'child maintenance', 'kid care', 'child guardianship', 'child manage', 'child deal']
chip design	['check design', 'crisp design', 'bit design', 'breakaway design', 'chip project', 'chip designing', 'chip plan']
chip layer	['chip level', 'check layer', 'bit layer', 'crisp layer', 'cutoff layer', 'scrap layer', 'chip bed']
chip performance	['check performance', 'bit performance', 'breakaway performance', 'crisp performance', 'chip operation', 'scrap performance', 'nick performance']
chocolate bar	['chocolate cake', 'chocolate BAR', 'coffee bar', 'chocolate block', 'chocolate stripe', 'cocoa bar', 'chocolate stop']
cigarette smoke	['cigarette smoking', 'butt smoke', 'cigarette fume', 'fag smoke', 'cigaret smoke', 'cigarette pot', 'cigarette dope']
citation form	['quote form', 'credit form', 'reference form', 'quotation form', 'Citation form', 'acknowledgment form', 'citation class']
city centre	['city Centre', 'city center', 'city middle', 'city focus', 'city heart', 'city core', 'city eye']
class member	['family member', 'year member', 'form member', 'category member', 'sort member', 'course member', 'division member']
class people	['category people', 'year people', 'course people', 'family people', 'separate people', 'form people', 'sort people']
class player	['year player', 'division player', 'form player', 'category player', 'course player', 'class musician', 'class actor']
class structure	['course structure', 'family structure', 'category structure', 'form structure', 'year structure', 'grade structure', 'separate structure']
client request	['customer request', 'guest request', 'client asking', 'node request', 'client quest', 'client petition', 'client callfor']
climate change	['climate shift', 'climate exchange', 'mood change', 'climate modification', 'climate transfer', 'climate variety', 'climate vary']
closing time	['end time', 'completion time', 'ending time', 'close time', 'shutdown time', 'shutdown time', 'closing sentence']
closing time	['end time', 'completion time', 'ending time', 'close time', 'shutdown time', 'shutdown time', 'closing sentence']
cloth makers	['cloth manufacturer', 'cloth Maker', 'cloth maker', 'fabric makers', 'textile makers', 'material makers', 'cloth Lord']
clothing store	['clothing shop', 'apparel store', 'dress store', 'clothing storage', 'wear store', 'clothing stock', 'garment store']
club house	['club home', 'club sign', 'club family', 'order house', 'guild house', 'club theatre', 'lodge house']
club house	['club home', 'club sign', 'club family', 'order house', 'guild house', 'club theatre', 'lodge house']
coast line	['coast business', 'coast air', 'coast stock', 'coast job', 'slide line', 'coast note', 'coast trace']
coast line	['coast business', 'coast air', 'coast stock', 'coast job', 'slide line', 'coast note', 'coast trace']
coconut plantation	['coconut grove', 'coconut Plantation', 'coco plantation', 'coconut orchard', 'cocoanut plantation', 'coconutpalm plantation', 'coconutmeat plantation']
coffee bean	['java bean', 'chocolate bean', 'coffee dome', 'coffeetree bean', 'burntumber bean', 'coffeeberry bean', 'umber bean']
coffee grinder	['coffee mill', 'chocolate grinder', 'coffee sub', 'coffee torpedo', 'coffee hero', 'coffeetree grinder', 'java grinder']
coffee machine	['chocolate machine', 'java machine', 'coffee car', 'coffee auto', 'coffee automobile', 'coffeetree machine', 'burntumber machine']
company car	['company auto', 'company machine', 'party car', 'society car', 'company automobile', 'companion car', 'fellowship car']
company contributions	['company share', 'company part', 'party contributions', 'company contribution', 'society contributions', 'company donation', 'fellowship contributions']
company law	['society law', 'company police', 'party law', 'fellowship law', 'caller law', 'companion law', 'accompany law']
company office	['company post', 'company position', 'company part', 'party office', 'company power', 'company agency', 'society office']
company partners	['company partner', 'party partners', 'society partners', 'fellowship partners', 'company spouse', 'company mate', 'companion partners']
company partners	['company partner', 'party partners', 'society partners', 'fellowship partners', 'company spouse', 'company mate', 'companion partners']
company president	['company President', 'society president', 'party president', 'company chairman', 'fellowship president', 'company chair', 'accompany president']
company store	['company stock', 'party store', 'company shop', 'society store', 'company fund', 'company storage', 'company memory']
company town	['company Town', 'party town', 'society town', 'company township', 'companion town', 'accompany town', 'fellowship town']
company town	['company Town', 'party town', 'society town', 'company township', 'companion town', 'accompany town', 'fellowship town']
computer age	['calculator age', 'computer years', 'computer mature', 'computingdevice age', 'electroniccomputer age', 'estimator age', 'informationprocessingsystem age']
computer center	['computer centre', 'computer core', 'computer eye', 'calculator center', 'computer heart', 'computer plaza', 'computer focus']
computer data	['computer information', 'calculator data', 'estimator data', 'computer datum', 'computingdevice data', 'electroniccomputer data', 'informationprocessingsystem data']
computer development	['calculator development', 'computer growing', 'computer evolution', 'computer developing', 'computer growth', 'estimator development', 'computer exploitation']
computer engineer	['computer direct', 'computer organize', 'estimator engineer', 'computer technologist', 'computer mastermind', 'calculator engineer', 'electroniccomputer engineer']
computer graphics	['computer art', 'computer graphic', 'computer artwork', 'calculator graphics', 'estimator graphics', 'computingdevice graphics', 'electroniccomputer graphics']
computer innovation	['computer design', 'computer introduction', 'computer foundation', 'computer creation', 'computer invention', 'computer conception', 'computer initiation']
computer maker	['computer manufacturer', 'computer Maker', 'computer Divine', 'computer Lord', 'computer Creator', 'calculator maker', 'computer shaper']
computer market	['calculator market', 'computer marketplace', 'computer marketplace', 'computer mart', 'computer grocery', 'estimator market', 'computingdevice market']
computer terminal	['computer last', 'computer end', 'computer depot', 'computer final', 'computer pole', 'estimator terminal', 'calculator terminal']
computer usage	['computer use', 'computer custom', 'computer exercise', 'computer employment', 'calculator usage', 'computer utilization', 'estimator usage']
computer vision	['calculator vision', 'computer imagination', 'computer sight', 'computingdevice vision', 'electroniccomputer vision', 'estimator vision', 'informationprocessingsystem vision']
cone clutch	['cone clutches', 'cone hold', 'cone clasp', 'cone grip', 'coneshape clutch', 'strobilus clutch', 'conoid clutch']
construction company	['building company', 'construction party', 'structure company', 'construction society', 'expression company', 'twist company', 'construction fellowship']
construction industry	['building industry', 'structure industry', 'construction manufacture', 'expression industry', 'twist industry', 'construction diligence', 'mentalsynthesis industry']
construction materials	['building materials', 'construction material', 'construction textile', 'construction fabric', 'structure materials', 'construction stuff', 'expression materials']
construction site	['building site', 'construction website', 'construction website', 'structure site', 'construction place', 'expression site', 'construction situation']
construction site	['building site', 'construction website', 'construction website', 'structure site', 'construction place', 'expression site', 'construction situation']
consultation event	['consultation case', 'reference event', 'interview event', 'audience event', 'consultation issue', 'consultation outcome', 'consultation result']
contact details	['link details', 'contact detail', 'contact point', 'contact item', 'meet details', 'touch details', 'striking details']
control panel	['control board', 'see panel', 'command panel', 'controller panel', 'moderate panel', 'master panel', 'check panel']
control tower	['control column', 'see tower', 'command tower', 'master tower', 'check tower', 'control hulk', 'controller tower']
conveyor belt	['conveyer belt', 'conveyor smash', 'transporter belt', 'conveyor rap', 'conveyorbelt belt', 'conveyerbelt belt', 'conveyor swath']
core element	['core component', 'CORE element', 'effect element', 'center element', 'core factor', 'core ingredient', 'heart element']
core element	['core component', 'CORE element', 'effect element', 'center element', 'core factor', 'core ingredient', 'heart element']
core idea	['CORE idea', 'center idea', 'core theme', 'heart idea', 'core mind', 'core thought', 'centre idea']
core strength	['CORE strength', 'center strength', 'core forte', 'heart strength', 'core force', 'core specialty', 'core effectiveness']
core value	['CORE value', 'center value', 'sum value', 'core rate', 'core measure', 'centre value', 'effect value']
corresponding member	['like member', 'match member', 'check member', 'fit member', 'represent member', 'agree member', 'tally member']
cotton industry	['cotton manufacture', 'cottonplant industry', 'cottonwool industry', 'cottonfiber industry', 'cotton diligence', 'cotton industriousness']
counting board	['counting card', 'number board', 'counting room', 'counting table', 'tally board', 'count board', 'counting plugin']
country access	['area access', 'land access', 'state access', 'nation access', 'country admission', 'country approach', 'commonwealth access']
course work	['class work', 'line work', 'course make', 'course go', 'course study', 'track work', 'course run']
credit card	['reference card', 'credit bill', 'recognition card', 'credit notice', 'credit board', 'acknowledgment card', 'credit menu']
crime lord	['crime Lord', 'crime master', 'crime Divine', 'offence lord', 'crime overlord', 'offense lord', 'lawbreaking lord']
crystal molecules	['crystal molecule', 'crystal particle', 'crystal atom', 'quartz molecules', 'crystal speck', 'watchcrystal molecules', 'watchglass molecules']
data format	['information format', 'data formatting', 'data initialize', 'data arrange', 'datum format', 'data initialise', 'data dataformat']
day trip	['Day trip', 'day travel', 'day tripper', 'day slip', 'day jaunt', 'day spark', 'day trigger']
day trip	['Day trip', 'day travel', 'day tripper', 'day slip', 'day jaunt', 'day spark', 'day trigger']
death certificate	['Death certificate', 'end certificate', 'death certification', 'destruction certificate', 'last certificate', 'death security', 'demise certificate']
death notice	['death note', 'Death notice', 'death card', 'last notice', 'death notification', 'death poster', 'death find']
death notice	['death note', 'Death notice', 'death card', 'last notice', 'death notification', 'death poster', 'death find']
death penalty	['Death penalty', 'death punishment', 'last penalty', 'end penalty', 'dying penalty', 'destruction penalty', 'demise penalty']
death sentence	['Death sentence', 'last sentence', 'death time', 'death doom', 'end sentence', 'death conviction', 'death condemnation']
deciding factor	['determining factor', 'determinant factor', 'determinative factor', 'deciding element', 'deciding agent', 'determine factor', 'decisionmaking factor']
design theme	['design idea', 'design report', 'design paper', 'design base', 'design subject', 'project theme', 'design topic']
design theme	['design idea', 'design report', 'design paper', 'design base', 'design subject', 'project theme', 'design topic']
destination port	['address port', 'destination interface', 'finish port', 'goal port', 'terminus port', 'nameandaddress port', 'destination porthole']
destroyer captain	['destroyer master', 'destroyer skipper', 'guidedmissiledestroyer captain', 'undoer captain', 'ruiner captain', 'uprooter captain', 'waster captain']
destroyer captain	['destroyer master', 'destroyer skipper', 'guidedmissiledestroyer captain', 'undoer captain', 'ruiner captain', 'uprooter captain', 'waster captain']
developed part	['get part', 'break part', 'train part', 'developed character', 'rise part', 'grow part', 'developed region']
development effort	['development movement', 'development campaign', 'development try', 'development drive', 'growing effort', 'developing effort', 'development cause']
development system	['development organization', 'development organisation', 'development scheme', 'growing system', 'growth system', 'evolution system', 'developing system']
direction keys	['direction key', 'direction Key', 'management keys', 'direction name', 'direction discover', 'way keys', 'direction identify']
disc set	['disc Set', 'record set', 'disk set', 'saucer set', 'disc fit', 'platter set', 'disc do']
discipline problem	['subject problem', 'check problem', 'correct problem', 'field problem', 'study problem', 'discipline job', 'correction problem']
discussion page	['discussion Page', 'word page', 'treatment page', 'discourse page', 'giveandtake page', 'discussion foliate', 'discussion varlet']
divided space	['shared space', 'separate space', 'divide space', 'part space', 'split space', 'divided place', 'splitup space']
division alignment	['partition alignment', 'class alignment', 'section alignment', 'part alignment', 'division alliance', 'segmentation alignment', 'division coalition']
dog meat	['dog heart', 'dog center', 'tail meat', 'track meat', 'tag meat', 'dog centre', 'dog core']
drinking water	['drink water', 'drinking H2O', 'drinking urine', 'drinking piss', 'drinkin water', 'drinking pee', 'imbibe water']
drug dealer	['drug trader', 'drug principal', 'dose dealer', 'dodrugs dealer', 'drug monger', 'drug bargainer']
drug dealer	['drug trader', 'drug principal', 'dose dealer', 'dodrugs dealer', 'drug monger', 'drug bargainer']
education program	['training program', 'Education program', 'education curriculum', 'education programme', 'education plan', 'breeding program', 'teaching program']
education system	['Education system', 'training system', 'education organization', 'teaching system', 'education scheme', 'education organisation', 'breeding system']
egg cell	['ball cell', 'testis cell', 'eggs cell', 'egg cellphone', 'testicle cell', 'bollock cell', 'orchis cell']
emergency surgery	['emergency OR', 'emergency operation', 'handbrake surgery', 'pinch surgery', 'parkingbrake surgery', 'exigency surgery', 'emergencybrake surgery']
emergency transportation	['emergency Transportation', 'emergency transport', 'emergency transfer', 'emergency transit', 'emergency shipping', 'emergency fare', 'emergency DoT']
end product	['finish product', 'close product', 'last product', 'end production', 'death product', 'stop product', 'destruction product']
end user	['last user', 'close user', 'stop user', 'terminal user', 'finish user', 'death user', 'terminate user']
energy issues	['energy supply', 'Energy issues', 'energy release', 'energy event', 'energy return', 'energy take', 'energy matter']
energy loss	['Energy loss', 'energy release', 'energy going', 'energy red', 'energy passing', 'energy deprivation', 'vitality loss']
energy price	['energy cost', 'Energy price', 'energy Price', 'energy terms', 'zip price', 'energy damage', 'push price']
energy source	['Energy source', 'energy generator', 'zip source', 'energy origin', 'energy author', 'energy reference', 'energy reservoir']
engagement ring	['mesh ring', 'engagement band', 'betrothal ring', 'engagement call', 'interlocking ring', 'date ring', 'fight ring']
enterprise applications	['enterprise application', 'initiative applications', 'enterprise covering', 'enterprise diligence', 'endeavor applications', 'endeavour applications', 'goahead applications']
enterprise level	['enterprise grade', 'enterprise even', 'enterprise story', 'enterprise point', 'initiative level', 'enterprise layer', 'enterprise tier']
entrance gates	['entrance gate', 'entrance Gates', 'entry gates', 'catch gates', 'entering gates', 'trance gates', 'incoming gates']
entrance way	['entry way', 'entrance room', 'entrance path', 'entrance direction', 'entrance means', 'entrance style', 'catch way']
episode information	['episode info', 'sequence information', 'episode data', 'installment information', 'instalment information', 'episode entropy', 'episode selectiveinformation']
excavations parts	['mining parts', 'excavations office', 'excavations section', 'dig parts', 'excavations start', 'excavations part', 'excavations share']
exchange rate	['exchange value', 'exchange place', 'exchange order', 'change rate', 'exchange rank', 'substitution rate', 'interchange rate']
expiration date	['release date', 'departure date', 'expiry date', 'termination date', 'exit date', 'loss date', 'passing date']
expiration date	['release date', 'departure date', 'expiry date', 'termination date', 'exit date', 'loss date', 'passing date']
eye contact	['center contact', 'centre contact', 'eye link', 'heart contact', 'eye meet', 'middle contact', 'eye touch']
eye medication	['heart medication', 'eye medicine', 'center medication', 'middle medication', 'centre medication', 'optic medication', 'eyeball medication']
factory machines	['factory car', 'mill machines', 'factory machine', 'factory auto', 'factory automobile', 'manufactory machines', 'manufacturingplant machines']
family company	['home company', 'class company', 'family party', 'category company', 'family society', 'house company', 'family companion']
family name	['category name', 'class name', 'household name', 'home name', 'family list', 'family key', 'family make']
father help	['get help', 'Father help', 'mother help', 'beginner help', 'generate help', 'father serve', 'don help']
fellow inmate	['fellow convict', 'fellow con', 'dude inmate', 'mate inmate', 'gent inmate', 'swain inmate', 'buster inmate']
fellow student	['associate student', 'fellow pupil', 'fellow scholar', 'beau student', 'companion student', 'colleague student', 'familiar student']
fencing coach	['debate coach', 'fencing tutor', 'wall coach', 'fence coach', 'fencing manager', 'fencing handler', 'fencing train']
fencing coach	['debate coach', 'fencing tutor', 'wall coach', 'fence coach', 'fencing manager', 'fencing handler', 'fencing train']
fighter jet	['hero jet', 'fighter K', 'fighter green', 'champion jet', 'fighter fountain', 'fighter jetplane', 'fighteraircraft jet']
fighter pilot	['fighter fly', 'hero pilot', 'fighter original', 'champion pilot', 'paladin pilot', 'fighteraircraft pilot', 'scrapper pilot']
fighting spirit	['active spirit', 'fighting heart', 'fighting life', 'fighting look', 'combat spirit', 'fighting tone', 'fight spirit']
fighting spirit	['active spirit', 'fighting heart', 'fighting life', 'fighting look', 'combat spirit', 'fighting tone', 'fight spirit']
film credits	['movie credits', 'picture credits', 'film reference', 'film credit', 'film citation', 'take credits', 'cinema credits']
film director	['movie director', 'picture director', 'cinema director', 'shoot director', 'take director', 'flick director', 'film manager']
film genre	['movie genre', 'picture genre', 'cinema genre', 'flick genre', 'take genre', 'shoot genre', 'movingpicture genre']
film production	['movie production', 'picture production', 'cinema production', 'film product', 'film output', 'shoot production', 'take production']
film unit	['movie unit', 'film whole', 'picture unit', 'take unit', 'cinema unit', 'pic unit', 'shoot unit']
film world	['movie world', 'cinema world', 'film global', 'film man', 'take world', 'picture world', 'film reality']
finish line	['complete line', 'last line', 'goal line', 'end line', 'finishing line', 'stop line', 'ending line']
finish line	['complete line', 'last line', 'goal line', 'end line', 'finishing line', 'stop line', 'ending line']
fire alarm	['fire alert', 'raise alarm', 'discharge alarm', 'attack alarm', 'can alarm', 'fuel alarm', 'provoke alarm']
fire department	['fire section', 'fuel department', 'can department', 'burn department', 'discharge department', 'attack department', 'sack department']
fire hazard	['fire risk', 'burn hazard', 'can hazard', 'fuel hazard', 'fire fortune', 'fire adventure', 'blast hazard']
fire officer	['attack officer', 'can officer', 'raise officer', 'terminate officer', 'discharge officer', 'burn officer', 'firing officer']
fish head	['Fish head', 'fish guide', 'angle head', 'fish point', 'fish pass', 'fish question', 'fish brain']
flight path	['flight itinerary', 'flight route', 'flight track', 'escape path', 'flight course', 'flight way', 'trajectory path']
flight review	['flight inspection', 'flight survey', 'escape review', 'flying review', 'flight recap', 'flight refresh', 'trajectory review']
food court	['food Court', 'food romance', 'food courtyard', 'food woo', 'food homage', 'intellectualnourishment court', 'foodforthought court']
football league	['football conference', 'footballgame league']
forest products	['wood products', 'timber products', 'forest product', 'forest production', 'woods products', 'woodland products', 'timberland products']
foundation policies	['introduction policies', 'innovation policies', 'base policies', 'foundation insurance', 'foundation policy', 'creation policies', 'institution policies']
founding secretary	['foundation secretary', 'institute secretary', 'plant secretary', 'institution secretary', 'innovation secretary', 'introduction secretary', 'base secretary']
freshman year	['freshman class', 'starter year', 'freshman yr', 'newcomer year', 'entrant year', 'newbie year', 'firstyear year']
freshman year	['freshman class', 'starter year', 'freshman yr', 'newcomer year', 'entrant year', 'newbie year', 'firstyear year']
front panel	['front board', 'face panel', 'look panel', 'movement panel', 'front gore', 'presence panel', 'breast panel']
gang violence	['mob violence', 'crowd violence', 'gang force', 'ring violence', 'pack violence', 'crew violence', 'gangup violence']
gas chamber	['gun chamber', 'gas bedroom', 'accelerator chamber', 'blow chamber', 'throttle chamber', 'gasoline chamber', 'gasconade chamber']
gas flow	['gas stream', 'gas flux', 'gas flowing', 'gas feed', 'gas run', 'gas course', 'gas current']
gas industry	['gun industry', 'gas manufacture', 'gasoline industry', 'petrol industry', 'accelerator industry', 'boast industry', 'blow industry']
gas leak	['gas leakage', 'gas escape', 'accelerator leak', 'gasoline leak', 'petrol leak', 'gas outflow', 'gasconade leak']
gas system	['throttle system', 'gun system', 'accelerator system', 'gas organisation', 'gasoline system', 'gas scheme', 'petrol system']
gathering place	['gathering spot', 'gathering space', 'gathering point', 'gathering home', 'gathering site', 'assembly place', 'gathering set']
gift shop	['gift store', 'giving shop', 'give shop', 'gift giveaway', 'gift sponsor', 'gift browse', 'gift workshop']
girls hockey	['girl hockey', 'miss hockey', 'girlfriend hockey', 'daughter hockey', 'girls fieldhockey', 'youngwoman hockey', 'missy hockey']
girls school	['miss school', 'girl school', 'girls train', 'daughter school', 'girls schooling', 'girlfriend school', 'girls educate']
glass tube	['glass pipe', 'glass tubing', 'glass subway', 'ice tube', 'glaze tube', 'glass metro', 'crank tube']
goose fossil	['zany fossil', 'goof fossil', 'cuckoo fossil', 'jackass fossil', 'bozo fossil', 'twat fossil', 'fathead fossil']
governance issues	['government issues', 'administration issues', 'organization issues', 'governance issue', 'governance supply', 'governance topic', 'governance event']
government agency	['government office', 'government authority', 'government means', 'administration agency', 'government way', 'government bureau', 'government representation']
government charge	['government level', 'administration charge', 'government commission', 'government bill', 'government care', 'government send', 'government direction']
government efforts	['government campaign', 'government effort', 'government movement', 'administration efforts', 'government attempt', 'government try', 'government drive']
government intelligence	['government news', 'politics intelligence', 'administration intelligence', 'government word', 'governing intelligence', 'governance intelligence', 'authorities intelligence']
government leaders	['government leadership', 'government leader', 'politics leaders', 'administration leaders', 'governance leaders', 'regime leaders', 'authorities leaders']
government minister	['administration minister', 'politics minister', 'governance minister', 'authorities minister', 'regime minister', 'government pastor', 'governing minister']
government opinion	['politics opinion', 'government view', 'government thought', 'government ruling', 'government sentiment', 'administration opinion', 'government feeling']
government organizations	['government organization', 'government administration', 'government system', 'government organisation', 'government constitution', 'governance organizations', 'government formation']
government radio	['politics radio', 'government wireless', 'authorities radio', 'administration radio', 'governing radio', 'regime radio', 'governance radio']
government troops	['regime troops', 'government troop', 'politics troops', 'government flock', 'authorities troops', 'government parade', 'governing troops']
government work	['government run', 'government employment', 'government act', 'government study', 'government make', 'administration work', 'politics work']
graduation day	['graduation Day', 'commencement day', 'graduation daytime', 'gradation day', 'commencementceremony day', 'commencementexercise day', 'graduationexercise day']
graduation day	['graduation Day', 'commencement day', 'graduation daytime', 'gradation day', 'commencementceremony day', 'commencementexercise day', 'graduationexercise day']
grain requirements	['grain demand', 'cereal requirements', 'grain essential', 'texture requirements', 'grain requirement', 'grain necessary', 'foodgrain requirements']
grape leaves	['grape leaf', 'grape will', 'grapevine leaves', 'grapevine leaves', 'grape give', 'grape leave', 'grape foliage']
green tea	['Green tea', 'park tea', 'K tea', 'jet tea', 'common tea', 'immature tea', 'greens tea']
groin injury	['groin wound', 'groin trauma', 'groin hurt', 'seawall injury', 'bulwark injury', 'jetty injury', 'breakwater injury']
ground floor	['ground level', 'ground base', 'base floor', 'earth floor', 'ground deck', 'found floor', 'soil floor']
ground unit	['base unit', 'ground whole', 'land unit', 'mash unit', 'earth unit', 'bray unit', 'labor unit']
group stage	['group level', 'group phase', 'group present', 'group point', 'group represent', 'group arrange', 'group degree']
growth period	['development period', 'growing period', 'growth point', 'growth stop', 'maturation period', 'emergence period', 'increase period']
guerrilla warfare	['guerrilla war', 'irregular warfare', 'guerilla warfare', 'insurgent warfare']
guest house	['Guest house', 'guest sign', 'guest home', 'guest family', 'client house', 'guest mansion', 'node house']
hair loss	['hair red', 'hair going', 'hair passing', 'whisker loss', 'hair deprivation', 'hair exit', 'fuzz loss']
hand injury	['hand wound', 'hand hurt', 'hand trauma', 'paw injury', 'give injury', 'hand harm', 'deal injury']
hate crimes	['hate crime', 'hate offense', 'hatred crimes', 'detest crimes', 'hate lawbreaking', 'hate criminaloffence', 'hate criminaloffense']
head injury	['brain injury', 'head trauma', 'head hurt', 'head wound', 'direct injury', 'guide injury', 'point injury']
heart attack	['middle attack', 'center attack', 'heart round', 'heart fire', 'heart approach', 'kernel attack', 'heart assault']
heart beat	['heart rhythm', 'heart get', 'meat beat', 'heart pound', 'heart round', 'eye beat', 'heart dead']
heart beat	['heart rhythm', 'heart get', 'meat beat', 'heart pound', 'heart round', 'eye beat', 'heart dead']
heart disease	['eye disease', 'nerve disease', 'center disease', 'marrow disease', 'core disease', 'spirit disease', 'affection disease']
heat index	['heat power', 'heat indicator', 'passion index', 'heating index', 'warmth index', 'wake index', 'rut index']
heightened level	['heightened degree', 'raise level', 'rise level', 'heightened even', 'compound level', 'enhance level', 'heightened charge']
home country	['home state', 'home area', 'home land', 'house country', 'home nation', 'national country', 'place country']
home town	['home Town', 'house town', 'family town', 'home township', 'place town', 'national town', 'base town']
home town	['home Town', 'house town', 'family town', 'home township', 'place town', 'national town', 'base town']
home video	['home TV', 'home television', 'family video', 'house video', 'home picture', 'national video', 'base video']
host country	['Host country', 'host nation', 'host state', 'server country', 'host area', 'host land', 'host commonwealth']
house keys	['house name', 'house paint', 'house key', 'house Key', 'home keys', 'house discover', 'house describe']
ice sheet	['ICE sheet', 'glass sheet', 'icing sheet', 'frosting sheet', 'ice sail', 'ice plane', 'ice canvas']
illumination conditions	['light conditions', 'illumination check', 'illumination condition', 'illumination weather', 'clarification conditions', 'illuminance conditions', 'illumination term']
information technology	['data technology', 'info technology', 'information engineering', 'entropy technology', 'selectiveinformation technology', 'information appliedscience', 'information engineeringscience']
inputs change	['comment change', 'input change', 'stimulus change', 'inputs vary', 'inputs switch', 'stimulation change', 'inputs shift']
installation process	['installation procedure', 'installation operation', 'installation work', 'induction process', 'initiation process', 'installation march', 'facility process']
intelligence agency	['news agency', 'intelligence bureau', 'intelligence office', 'intelligence means', 'word agency', 'intelligence authority', 'intelligence way']
intersection point	['crossing point', 'convergence point', 'product point', 'intersection head', 'intersection stop', 'intersection signal', 'intersection level']
item information	['detail information', 'item info', 'particular information', 'item data', 'point information', 'token information', 'item entropy']
job performance	['business performance', 'Job performance', 'line performance', 'task performance', 'job execution', 'job operation', 'problem performance']
kernel sources	['kernel source', 'meat sources', 'center sources', 'kernel root', 'kernel reference', 'core sources', 'kernel seed']
known one	['know one', 'love one', 'experience one', 'known I', 'known i', 'live one', 'bed one']
labor union	['Labor union', 'labor Union', 'labour union', 'Labour union', 'drive union', 'labor Federal', 'labor North']
land bridge	['Land bridge', 'state bridge', 'down bridge', 'estate bridge', 'ground bridge', 'country bridge', 'land span']
land claims	['land title', 'Land claims', 'land claim', 'state claims', 'land take', 'down claims', 'bring claims']
land grant	['Land grant', 'land Grant', 'state grant', 'estate grant', 'land give', 'country grant', 'down grant']
land survey	['soil survey', 'Land survey', 'state survey', 'land view', 'land review', 'estate survey', 'down survey']
land taxation	['land tax', 'estate taxation', 'state taxation', 'land revenue', 'Land taxation', 'nation taxation', 'country taxation']
language courses	['language course', 'language class', 'language line', 'language grade', 'language form', 'language track', 'speech courses']
language groups	['language group', 'speech groups', 'words groups', 'language grouping', 'language radical', 'nomenclature groups', 'terminology groups']
language problems	['speech problems', 'language job', 'language problem', 'words problems', 'terminology problems', 'language trouble', 'nomenclature problems']
language speakers	['language Speaker', 'language speaker', 'words speakers', 'speech speakers', 'lyric speakers', 'language talker', 'oralcommunication speakers']
language understanding	['language see', 'language read', 'language translate', 'speech understanding', 'language understand', 'words understanding', 'terminology understanding']
law education	['law Education', 'law training', 'law teaching', 'police education', 'law instruction', 'jurisprudence education', 'law pedagogy']
law school	['police school', 'law train', 'law educate', 'jurisprudence school', 'law schooling', 'constabulary school', 'law schoolhouse']
learning process	['acquisition process', 'learning work', 'study process', 'check process', 'learning action', 'learning march', 'scholarship process']
learning style	['watch style', 'learning mode', 'learning fashion', 'read style', 'see style', 'learning title', 'study style']
lecture hall	['lecture Hall', 'talk hall', 'speech hall', 'lecturing hall', 'rag hall', 'lecture mansion', 'lecture dorm']
life change	['life transfer', 'life switch', 'living change', 'life exchange', 'life alter', 'life variety', 'life shift']
life change	['life transfer', 'life switch', 'living change', 'life exchange', 'life alter', 'life variety', 'life shift']
life expectancy	['lifetime expectancy', 'lifetime expectancy', 'life anticipation', 'living expectancy', 'lifespan expectancy', 'animation expectancy', 'spirit expectancy']
life story	['life history', 'life report', 'life account', 'life level', 'life tale', 'living story', 'life narrative']
liquor store	['liquor shop', 'spirits store', 'liquor storage', 'liquor fund', 'liquor depot', 'booze store', 'liquor stock']
living conditions	['life conditions', 'support conditions', 'living weather', 'living condition', 'live conditions', 'living status', 'be conditions']
lobby area	['hall area', 'foyer area', 'vestibule area', 'lobby arena', 'anteroom area', 'lobby field', 'lobby country']
luxury automobile	['luxury car', 'luxury auto', 'luxury machine', 'luxury motorcar', 'sumptuousness automobile', 'sumptuosity automobile', 'luxuriousness automobile']
machine language	['machine terminology', 'machine words', 'car language', 'auto language', 'machine speech', 'machine lyric', 'automobile language']
magnifying glass	['enlarge glass', 'magnify glass', 'exaggerate glass', 'overstate glass', 'hyperbolize glass', 'hyperbolise glass', 'amplify glass']
majority cases	['bulk cases', 'majority cause', 'majority character', 'majority type', 'majority case', 'majority face', 'majority event']
mall entrance	['center entrance', 'plaza entrance', 'mall entry', 'mall catch', 'promenade entrance', 'mall incoming', 'mall charm']
mankind instruction	['world instruction', 'man instruction', 'mankind statement', 'mankind teaching', 'mankind education', 'humankind instruction', 'humanbeings instruction']
mansion house	['house house', 'hall house', 'mansion home', 'sign house', 'residence house', 'mansion theatre', 'mansion family']
mapping process	['function process', 'map process', 'mapping work', 'mapping procedure', 'mapping operation', 'mapping march', 'mapping action']
market conditions	['market status', 'market condition', 'market check', 'market discipline', 'market weather', 'market train', 'marketplace conditions']
market place	['market rate', 'market home', 'market position', 'market space', 'market property', 'market set', 'market site']
market place	['market rate', 'market home', 'market position', 'market space', 'market property', 'market set', 'market site']
mass destruction	['Mass destruction', 'mass death', 'mass end', 'mountain destruction', 'mass devastation', 'people destruction', 'deal destruction']
mass destruction	['Mass destruction', 'mass death', 'mass end', 'mountain destruction', 'mass devastation', 'people destruction', 'deal destruction']
meat animals	['centre animals', 'meat animal', 'heart animals', 'center animals', 'meat beast', 'sum animals', 'essence animals']
meat consumption	['meat intake', 'meat use', 'center consumption', 'meat ingestion', 'centre consumption', 'substance consumption', 'core consumption']
media commentators	['media commentator', 'media observer', 'media reviewer', 'sensitive commentators', 'massmedium commentators', 'medium commentators', 'spiritualist commentators']
media player	['media participant', 'media musician', 'medium player', 'sensitive player', 'media actor', 'media thespian', 'massmedium player']
media relations	['media congress', 'media relation', 'media telling', 'media relative', 'sensitive relations', 'media intercourse', 'media dealings']
media support	['media subscribe', 'media back', 'media stand', 'media living', 'media funding', 'media keep', 'medium support']
media technologies	['media technology', 'media engineering', 'sensitive technologies', 'medium technologies', 'massmedium technologies', 'spiritualist technologies', 'metier technologies']
melting point	['melt point', 'run point', 'melting stage', 'melting head', 'melting tip', 'melting spot', 'melting period']
members return	['members take', 'members give', 'member return', 'members pass', 'members fall', 'members deliver', 'members refund']
memory issue	['memory effect', 'memory outlet', 'memory return', 'memory number', 'storage issue', 'memory take', 'store issue']
memory leak	['memory leakage', 'memory escape', 'store leak', 'storage leak', 'memoryboard leak', 'retention leak', 'remembering leak']
memory utilization	['memory usage', 'memory use', 'storage utilization', 'memory exercise', 'memory utilisation', 'retention utilization', 'memory employment']
metro area	['metro region', 'metro country', 'underground area', 'tube area', 'metro arena', 'metro field', 'subway area']
million dollar	['billion dollar', 'trillion dollar', 'zillion dollar', 'gazillion dollar', 'million buck', 'jillion dollar', '1000000 dollar']
mission change	['charge change', 'commission change', 'mission variety', 'mission shift', 'mission exchange', 'delegation change', 'mission transfer']
mission control	['mission command', 'mission see', 'charge control', 'mission master', 'mission check', 'commission control', 'mission controller']
mountain bike	['mount bike', 'mountain bicycle', 'mountain cycle', 'mass bike', 'mountain motorcycle', 'lot bike', 'deal bike']
mountain goat	['mountain Goat', 'mint goat', 'lot goat', 'pot goat', 'sight goat', 'flock goat', 'batch goat']
mountain range	['mountain chain', 'mountain run', 'mountain place', 'mass range', 'mount range', 'mountain pasture', 'sight range']
movie list	['movie name', 'picture list', 'film list', 'movie listing', 'pic list', 'movie number', 'flick list']
movie star	['film star', 'movie starring', 'picture star', 'movie superstar', 'movie leading', 'movie maven', 'pic star']
muscle contractions	['muscle contraction', 'muscle compression', 'brawn contractions', 'musculartissue contractions', 'muscleman contractions', 'brawniness contractions', 'sinew contractions']
music school	['medicine school', 'music train', 'music schooltime', 'music schooling', 'music educate', 'music schoolday', 'music schoolhouse']
muslim countries	['Muslim countries', 'Islamic countries', 'muslim country', 'muslim nation', 'muslim state', 'muslim land', 'Moslem countries']
mystery story	['secret story', 'mystery tale', 'mystery history', 'mystery narration', 'mystery narrative', 'mystery report', 'mystery level']
neural network	['neural net', 'neuronal network', 'neural mesh', 'nervous network', 'neural web', 'neuronic network', 'neural meshwork']
neural network	['neural net', 'neuronal network', 'neural mesh', 'nervous network', 'neural web', 'neuronic network', 'neural meshwork']
noise pollution	['noise contamination', 'disturbance pollution', 'interference pollution', 'randomness pollution', 'resound pollution', 'haphazardness pollution', 'stochasticity pollution']
noise pollution	['noise contamination', 'disturbance pollution', 'interference pollution', 'randomness pollution', 'resound pollution', 'haphazardness pollution', 'stochasticity pollution']
noodle preparation	['bean preparation', 'noodle cooking', 'dome preparation', 'noodle cookery', 'bonce preparation', 'attic preparation', 'noggin preparation']
office building	['spot building', 'office make', 'place building', 'office construction', 'authority building', 'post building', 'power building']
opening match	['open match', 'opening pair', 'opening couple', 'opening meet', 'opening check', 'give match', 'opening playoff']
opposition member	['Opposition member', 'resistance member', 'opposite member', 'opponent member', 'enemy member', 'foe member', 'foeman member']
opposition protesters	['Opposition protesters', 'opposition protester', 'opposition demonstrator', 'opposition dissident', 'confrontation protesters', 'resistance protesters', 'enemy protesters']
opposition radio	['resistance radio', 'foe radio', 'enemy radio', 'Opposition radio', 'opposite radio', 'confrontation radio', 'opponent radio']
order execution	['Order execution', 'order performance', 'order implementation', 'rate execution', 'order murder', 'say execution', 'setup execution']
organized crime	['organised crime', 'form crime', 'organize crime', 'direct crime', 'coordinate crime', 'mastermind crime', 'organise crime']
papal approval	['papal blessing', 'apostolic approval', 'pontifical approval', 'papal commendation', 'apostolical approval', 'papal favorablereception', 'papal favourablereception']
paper certificate	['paper security', 'paper certification', 'report certificate', 'theme certificate', 'paper credentials', 'composition certificate', 'paper credential']
paper plate	['paper home', 'paper scale', 'paper shell', 'report plate', 'newspaper plate', 'theme plate', 'composition plate']
park bench	['Park bench', 'park Bench', 'park terrace', 'green bench', 'common bench', 'parkland bench', 'parkingarea bench']
particle model	['atom model', 'particle simulation', 'molecule model', 'particle modeling', 'particle example', 'particle modelling', 'particle pattern']
particle physics	['atom physics', 'molecule physics', 'particle physic', 'mote physics', 'corpuscle physics', 'subatomicparticle physics', 'speck physics']
patron saint	['sponsor saint', 'patron angel', 'supporter saint', 'frequenter saint', 'patron nonesuch', 'patron canonize', 'patron enshrine']
pattern recognition	['shape recognition', 'pattern identification', 'form recognition', 'design recognition', 'practice recognition', 'model recognition', 'pattern credit']
pattern recognition	['shape recognition', 'pattern identification', 'form recognition', 'design recognition', 'practice recognition', 'model recognition', 'pattern credit']
performance space	['performance place', 'operation space', 'performance quad', 'performance distance', 'execution space', 'performance infinite', 'functioning space']
petroleum fires	['petroleum fuel', 'oil fires', 'petroleum fire', 'petroleum can', 'petroleum discharge', 'crude fires', 'petroleum raise']
petroleum investment	['oil investment', 'crude investment', 'petroleum investing', 'fossiloil investment', 'crudeoil investment', 'rockoil investment', 'petroleum investiture']
petroleum pipelines	['oil pipelines', 'petroleum pipeline', 'crude pipelines', 'petroleum line', 'fossiloil pipelines', 'crudeoil pipelines', 'rockoil pipelines']
physics community	['cathartic community', 'physic community', 'purgative community', 'physicalscience community', 'naturalphilosophy community', 'aperient community', 'physics bioticcommunity']
physics lab	['physics laboratory', 'physic lab', 'purgative lab', 'physicalscience lab', 'cathartic lab', 'naturalphilosophy lab', 'aperient lab']
piano lesson	['piano example', 'soft lesson', 'fortepiano lesson', 'pianissimo lesson', 'pianoforte lesson', 'softly lesson', 'piano objectlesson']
pilot error	['original error', 'buffer error', 'fly error', 'navigate error', 'pilot mistake', 'pilot fault', 'pilotprogram error']
plantation owner	['Plantation owner', 'orchard owner', 'grove owner', 'plantation proprietor', 'woodlet owner', 'plantation possessor']
player skill	['player acquisition', 'player science', 'participant skill', 'actor skill', 'musician skill', 'thespian skill', 'roleplayer skill']
playing career	['acting career', 'work career', 'act career', 'performing career', 'play career', 'run career', 'meet career']
police radar	['patrol radar', 'law radar', 'constabulary radar', 'policeforce radar', 'police microwaveradar', 'police radiodetectionandranging', 'police radiolocation']
pool water	['pond water', 'kitty water', 'puddle water', 'consortium water', 'syndicate water', 'pool H2O', 'pool pee']
pop singer	['pop Singer', 'popular singer', 'pop vocalist', 'pa singer', 'down singer', 'dad singer', 'kill singer']
positive reinforcement	['positive support', 'positive reward', 'positive reinforcer', 'positive reenforcement', 'plus reinforcement', 'confident reinforcement', 'prescribed reinforcement']
post office	['Post office', 'post post', 'office office', 'mail office', 'post function', 'post position', 'post part']
post office	['Post office', 'post post', 'office office', 'mail office', 'post function', 'post position', 'post part']
power vacuum	['power hoover', 'power void', 'index vacuum', 'force vacuum', 'office vacuum', 'king vacuum', 'might vacuum']
pressure area	['press area', 'force area', 'pressure field', 'pressing area', 'pressure region', 'hale area', 'pressure sphere']
pressure group	['press group', 'force group', 'blackjack group', 'hale group', 'squeeze group', 'coerce group', 'pressure grouping']
produced versions	['produced version', 'create versions', 'get versions', 'make versions', 'produce versions', 'produced adaptation', 'develop versions']
program issues	['program return', 'program event', 'program take', 'program subject', 'program number', 'curriculum issues', 'program release']
property rights	['property right', 'place rights', 'holding rights', 'prop rights', 'attribute rights', 'property correct', 'property compensate']
protagonist role	['friend role', 'champion role', 'protagonist character', 'booster role', 'protagonist use', 'protagonist persona', 'supporter role']
publishing deal	['publishing trade', 'publishing share', 'publishing sell', 'issue deal', 'publishing take', 'release deal', 'publishing address']
punctuated rhythm	['stress rhythm', 'accent rhythm', 'mark rhythm', 'emphasize rhythm', 'accentuate rhythm', 'emphasise rhythm', 'punctuated round']
puppet wolves	['puppet wolf', 'puppet Wolf', 'creature wolves', 'puppet beast', 'marionette wolves', 'tool wolves', 'puppet savage']
quality control	['quality check', 'tone control', 'quality see', 'select control', 'quality controller', 'choice control', 'quality master']
quality job	['select job', 'quality business', 'quality problem', 'quality Job', 'quality line', 'quality task', 'choice job']
quality school	['select school', 'choice school', 'quality schooling', 'quality train', 'prize school', 'character school', 'tone school']
quality school	['select school', 'choice school', 'quality schooling', 'quality train', 'prize school', 'character school', 'tone school']
quality software	['select software', 'prime software', 'quality package', 'choice software', 'tone software', 'character software', 'calibre software']
quarter finals	['quarter final', 'draw finals', 'fourth finals', 'twentyfivepercent finals', 'tail finals', 'poop finals', 'drawandquarter finals']
rabbit meat	['rabbit heart', 'rabbit center', 'hare meat', 'rabbit core', 'rabbit marrow', 'cony meat', 'lapin meat']
race car	['wash car', 'speed car', 'run car', 'race auto', 'race machine', 'rush car', 'race automobile']
race conditions	['race condition', 'race check', 'race weather', 'race status', 'run conditions', 'race shape', 'speed conditions']
radio audience	['radio interview', 'wireless audience', 'radio hearing', 'radio consultation', 'receivingset audience', 'tuner audience', 'radioset audience']
radio service	['wireless service', 'radio Service', 'radio help', 'radio servicing', 'tuner service', 'radio serving', 'radiocommunication service']
radio station	['radio post', 'wireless station', 'radio send', 'radio place', 'tuner station', 'receivingset station', 'radioset station']
radio version	['radio reading', 'radio edition', 'wireless version', 'radio adaptation', 'tuner version', 'radio translation', 'radio rendering']
rail network	['train network', 'track network', 'rail net', 'rail web', 'rails network', 'runway network', 'rail mesh']
rail network	['train network', 'track network', 'rail net', 'rail web', 'rails network', 'runway network', 'rail mesh']
railway regulations	['railroad regulations', 'railway regulation', 'railway rule', 'railway regulating', 'railway ordinance', 'railroadtrack regulations', 'railwaysystem regulations']
rap group	['strike group', 'belt group', 'pink group', 'tap group', 'hiphop group', 'pat group', 'blame group']
rebel barons	['rebel king', 'Rebel barons', 'rebel power', 'rebel baron', 'rebel tycoon', 'insurgent barons', 'freedomfighter barons']
rebel barons	['rebel king', 'Rebel barons', 'rebel power', 'rebel baron', 'rebel tycoon', 'insurgent barons', 'freedomfighter barons']
record company	['book company', 'register company', 'enter company', 'show company', 'read company', 'record society', 'tape company']
recording quality	['show quality', 'read quality', 'register quality', 'record quality', 'transcription quality', 'tape quality', 'recording select']
reinforcement learning	['support learning', 'reward learning', 'reinforcement check', 'reinforcement see', 'reinforcement read', 'reinforcement take', 'reinforcement learn']
reinforcement learning	['support learning', 'reward learning', 'reinforcement check', 'reinforcement see', 'reinforcement read', 'reinforcement take', 'reinforcement learn']
relativity textbook	['relativity text', 'relativitytheory textbook', 'Einsteinstheoryofrelativity textbook', 'theoryofrelativity textbook', 'relativity textedition', 'relativity casebook', 'relativity schoolbook']
release date	['expiration date', 'departure date', 'issue date', 'publish date', 'free date', 'release see', 'exit date']
relief operation	['backup operation', 'relief process', 'relief surgery', 'relief performance', 'relief procedure', 'rest operation', 'ease operation']
replacement list	['switch list', 'replacement number', 'alternate list', 'replacement name', 'renewal list', 'substitute list', 'substitution list']
reserve balances	['reserve balance', 'reserve Balance', 'book balances', 'reserve rest', 'reserve remainder', 'hold balances', 'appropriate balances']
resistance groups	['opposition groups', 'resistance group', 'underground groups', 'immunity groups', 'resistance radical', 'resistor groups', 'resistance grouping']
resource management	['imagination management', 'resource direction', 'resourcefulness management']
resting posture	['resting position', 'resting pose', 'rest posture', 'breathe posture', 'pillow posture', 'resting stance', 'resting model']
return trip	['fall trip', 'return travel', 'take trip', 'return trigger', 'homecoming trip', 'return slip', 'pass trip']
review process	['review march', 'review action', 'inspection process', 'review work', 'review procedure', 'survey process', 'reassessment process']
rice consumption	['Rice consumption', 'rice use', 'rice intake', 'ElmerRice consumption', 'ElmerLeopoldRice consumption', 'SirTimRice consumption', 'ElmerReizenstein consumption']
rice field	['Rice field', 'rice plain', 'rice area', 'rice subject', 'rice study', 'rice theatre', 'rice arena']
rice field	['Rice field', 'rice plain', 'rice area', 'rice subject', 'rice study', 'rice theatre', 'rice arena']
rice shop	['Rice shop', 'rice grass', 'rice rat', 'rice browse', 'rice store', 'rice workshop', 'rice sponsor']
ring road	['border road', 'telephone road', 'band road', 'call road', 'pack road', 'ring route', 'phone road']
ring road	['border road', 'telephone road', 'band road', 'call road', 'pack road', 'ring route', 'phone road']
rocky ground	['rough ground', 'rocky soil', 'stony ground', 'rocky land', 'rocky base', 'rocky earth', 'bumpy ground']
root channel	['root canal', 'source channel', 'base channel', 'root line', 'theme channel', 'solution channel', 'origin channel']
running time	['run time', 'lead time', 'play time', 'work time', 'working time', 'go time', 'track time']
salt marsh	['SALT marsh', 'salt Marsh', 'salinity marsh', 'salt marshland', 'commonsalt marsh', 'StrategicArmsLimitationTalks marsh', 'tablesalt marsh']
scale model	['scale modeling', 'plate model', 'scale pattern', 'shell model', 'scale modelling', 'scale simulation', 'scale example']
school alumni	['school graduate', 'school grad', 'school alumnus', 'school alum', 'school alumna', 'train alumni', 'educate alumni']
school board	['school room', 'school table', 'school card', 'school panel', 'train board', 'educate board', 'cultivate board']
school bus	['train bus', 'school coach', 'school heap', 'school omnibus', 'schooling bus', 'shoal bus', 'schoolhouse bus']
school day	['school Day', 'train day', 'school daytime', 'schooling day', 'school daylight', 'cultivate day', 'educate day']
school day	['school Day', 'train day', 'school daytime', 'schooling day', 'school daylight', 'cultivate day', 'educate day']
school friend	['school Friend', 'school booster', 'school champion', 'school Quaker', 'school acquaintance', 'school supporter', 'school ally']
school program	['school curriculum', 'school plan', 'school programme', 'train program', 'school syllabus', 'schooling program', 'school broadcast']
school record	['school book', 'school read', 'school show', 'school register', 'school enter', 'school tape', 'school disc']
science fiction	['science fabrication', 'skill fiction', 'science fable', 'scientificdiscipline fiction']
screen shot	['screen flash', 'screen film', 'test shot', 'cover shot', 'screen snapshot', 'screen charge', 'screen scene']
seat belt	['rear belt', 'can belt', 'bottom belt', 'tail belt', 'ass belt', 'place belt', 'seat bang']
security authorities	['security agency', 'security office', 'security authorization', 'security government', 'security assurance', 'security bureau', 'certificate authorities']
security relation	['security congress', 'security relative', 'security telling', 'protection relation', 'certificate relation', 'surety relation', 'securitymeasure relation']
serving officer	['service officer', 'help officer', 'process officer', 'do officer', 'function officer', 'attend officer', 'assist officer']
sewing machine	['stitching machine', 'stitch machine', 'sew machine', 'sewing car', 'sewing auto', 'tailor machine', 'stitchery machine']
sheet music	['canvas music', 'tabloid music', 'plane music', 'rag music', 'sheet medicine', 'tack music', 'sail music']
short film	['short movie', 'short take', 'little film', 'light film', 'dead film', 'poor film', 'short picture']
side doorway	['side door', 'side threshold', 'face doorway', 'position doorway', 'sideofmeat doorway', 'slope doorway', 'incline doorway']
sign language	['contract language', 'house language', 'signed language', 'mark language', 'gestural language', 'sign words', 'signal language']
silver atoms	['silver speck', 'silver atom', 'silver particle', 'Ag atoms', 'silver molecule', 'atomicnumber47 atoms', 'ashgray atoms']
silver medal	['silver ribbon', 'silver palm', 'silver medallion', 'silver decoration', 'argent medal', 'atomicnumber47 medal', 'ashgray medal']
site name	['site list', 'place name', 'site make', 'website name', 'website name', 'site call', 'site discover']
ski resort	['ski repair', 'ski refuge', 'ski hangout', 'ski haunt', 'ski recur', 'ski recourse', 'ski holidayresort']
skin change	['hide change', 'skin switch', 'peel change', 'skin variety', 'skin transfer', 'struggle change', 'skin exchange']
skin change	['hide change', 'skin switch', 'peel change', 'skin variety', 'skin transfer', 'struggle change', 'skin exchange']
slate roof	['slate cap', 'slating roof', 'slate ceiling', 'ticket roof']
song competition	['song contest', 'vocal competition', 'Song competition', 'call competition', 'strain competition', 'song contender', 'song contention']
south division	['S division', 'South division', 'south part', 'south section', 'Dixie division', 'south class', 'south partition']
southeast coast	['Southeast coast', 'southeastern coast', 'SE coast', 'southeast seacoast', 'southeast seacoast', 'southeasterly coast', 'southeast glide']
speech recognition	['language recognition', 'address recognition', 'words recognition', 'speech credit', 'speech identification', 'delivery recognition', 'lecture recognition']
speed limit	['upper limit', 'speed set', 'speed throttle', 'speed limitation', 'speed fix', 'velocity limit', 'race limit']
spending reductions	['spending reduction', 'expenditure reductions', 'spending reducing', 'spending decrease', 'spend reductions', 'outlay reductions', 'pass reductions']
splash guard	['splatter guard', 'slush guard', 'spatter guard', 'splash safety', 'splashing guard', 'splash ward', 'splash hold']
sports stadium	['sports arena', 'sports bowl', 'sport stadium', 'athletics stadium', 'play stadium', 'feature stadium', 'fun stadium']
state approval	['State approval', 'express approval', 'state approving', 'nation approval', 'country approval', 'submit approval', 'say approval']
state enterprise	['State enterprise', 'state initiative', 'express enterprise', 'land enterprise', 'say enterprise', 'country enterprise', 'nation enterprise']
state oil	['State oil', 'country oil', 'express oil', 'say oil', 'land oil', 'state petroleum', 'nation oil']
state police	['state law', 'State police', 'state patrol', 'say police', 'nation police', 'tell police', 'country police']
state president	['State president', 'state President', 'state chair', 'state chairman', 'country president', 'nation president', 'tell president']
state product	['submit product', 'State product', 'country product', 'express product', 'land product', 'state production', 'state merchandise']
steel industry	['steel manufacture', 'blade industry', 'brand industry', 'sword industry', 'nerve industry', 'steel diligence', 'steel industriousness']
stem cell	['base cell', 'root cell', 'theme cell', 'stalk cell', 'radical cell', 'halt cell', 'bow cell']
storage capacity	['memory capacity', 'storage capability', 'storage content', 'store capacity', 'warehousing capacity', 'storage capacitance', 'reposition capacity']
strip club	['rifle club', 'clean club', 'strip order', 'peel club', 'striptease club', 'strip nightclub', 'strip nine']
student death	['student last', 'student Death', 'student end', 'student dying', 'pupil death', 'scholar death', 'student expiry']
student groups	['student group', 'student grouping', 'student radical', 'scholar groups', 'pupil groups', 'educatee groups', 'bookman groups']
student newspaper	['student paper', 'scholar newspaper', 'student newsprint', 'educatee newspaper', 'pupil newspaper', 'bookman newspaper', 'scholarlyperson newspaper']
student residence	['student residency', 'student hall', 'pupil residence', 'student abode', 'scholar residence', 'educatee residence', 'bookman residence']
substance use	['content use', 'message use', 'center use', 'means use', 'centre use', 'core use', 'meaning use']
subway cars	['subway car', 'metro cars', 'tube cars', 'underground cars', 'subway automobile', 'underpass cars', 'subwaysystem cars']
sugar cube	['sugar block', 'bread cube', 'sugar dice', 'dough cube', 'kale cube', 'lettuce cube', 'carbohydrate cube']
suicide note	['suicide bill', 'suicide line', 'suicide mark', 'suicide notice', 'suicide remark', 'suicide observe', 'suicide mention']
sun god	['Sun god', 'sun God', 'Sunday god', 'sun deity', 'sunshine god', 'sun divinity', 'sunlight god']
support group	['funding group', 'living group', 'back group', 'supporting group', 'documentation group', 'bear group', 'backup group']
surface area	['open area', 'surface field', 'rise area', 'surface region', 'surface domain', 'surface sphere', 'coat area']
surface waters	['surface water', 'surface Waters', 'open waters', 'surface urine', 'rise waters', 'surface H2O', 'surface pee']
survey area	['study area', 'view area', 'survey field', 'review area', 'survey region', 'follow area', 'resume area']
system engineer	['system direct', 'system organize', 'system technologist', 'system organise', 'system orchestrate', 'organization engineer', 'scheme engineer']
tail section	['bottom section', 'seat section', 'rear section', 'quarter section', 'trail section', 'chase section', 'track section']
tap water	['pink water', 'tip water', 'strike water', 'hydrant water', 'bug water', 'spigot water', 'tap H2O']
tape recorder	['record recorder', 'videotape recorder', 'magnetictape recorder', 'tapeline recorder', 'tapemeasure recorder', 'magtape recorder', 'taping recorder']
task declaration	['tax declaration', 'task resolution', 'labor declaration', 'project declaration', 'task announcement', 'task contract', 'undertaking declaration']
telephone use	['phone use', 'call use', 'telephone usage', 'ring use', 'telephone employment', 'telephone practice', 'telephone function']
television channel	['tv channel', 'TV channel', 'video channel', 'television transport', 'television line', 'television canal', 'television transfer']
television company	['video company', 'tv company', 'TV company', 'television society', 'television party', 'television companion', 'television fellowship']
television projects	['video projects', 'tv projects', 'TV projects', 'television picture', 'television see', 'television design', 'television project']
television viewer	['video viewer', 'tv viewer', 'TV viewer', 'television watcher', 'television spectator', 'television witness', 'television looker']
television work	['video work', 'tv work', 'TV work', 'television make', 'television play', 'television go', 'television act']
test case	['test subject', 'test event', 'test type', 'test example', 'run case', 'trial case', 'screen case']
test division	['test class', 'test part', 'test section', 'trial division', 'run division', 'examination division', 'essay division']
threshold issue	['threshold number', 'threshold effect', 'door issue', 'threshold matter', 'threshold return', 'threshold subject', 'threshold event']
thrilling action	['thrilling activity', 'thrill action', 'electrifying action', 'thrilling process', 'shiver action', 'inebriate action', 'beatify action']
time bomb	['time turkey', 'time fail', 'clock bomb', 'metre bomb', 'time dud', 'time bombard', 'meter bomb']
time limit	['time set', 'time limitation', 'time bound', 'time fix', 'time determine', 'time define', 'time specify']
time machine	['time car', 'time auto', 'clock machine', 'meter machine', 'time automobile', 'clip machine', 'sentence machine']
time machine	['time car', 'time auto', 'clock machine', 'meter machine', 'time automobile', 'clip machine', 'sentence machine']
time scale	['meter scale', 'time shell', 'time plate', 'clock scale', 'metre scale', 'clip scale', 'time surmount']
time span	['time cross', 'time duet', 'time bridge', 'time couple', 'time twosome', 'time duo', 'time sweep']
title character	['title type', 'title role', 'title part', 'title case', 'title quality', 'title reference', 'style character']
toilet seat	['can seat', 'potty seat', 'toilet can', 'stool seat', 'commode seat', 'bathroom seat', 'throne seat']
tour guide	['tour take', 'go guide', 'tour guidebook', 'tour head', 'tour direct', 'tour run', 'circuit guide']
town centre	['Town centre', 'town Centre', 'town center', 'township centre', 'town core', 'town middle', 'town heart']
trade agreement	['sell agreement', 'swap agreement', 'trade accord', 'trade arrangement', 'deal agreement', 'barter agreement', 'trade understanding']
trade card	['trade board', 'trade poster', 'trade bill', 'switch card', 'craft card', 'trade posting', 'deal card']
trade deal	['trade trade', 'swap deal', 'deal deal', 'trade sell', 'trade share', 'trade address', 'trade take']
train crash	['train wreck', 'coach crash', 'rail crash', 'train smash', 'string crash', 'school crash', 'gear crash']
training members	['education members', 'aim members', 'training member', 'school members', 'educate members', 'direct members', 'train members']
transformation industry	['translation industry', 'shift industry', 'transformation manufacture', 'transmutation industry', 'transformation diligence', 'transformation industriousness']
transmission system	['transmission organization', 'infection system', 'transmitting system', 'transmission scheme', 'transmittal system', 'transmission arrangement', 'transmission organisation']
transport activity	['channel activity', 'transfer activity', 'transport action', 'shipping activity', 'ship activity', 'transportation activity', 'send activity']
trash heap	['scrap heap', 'trash pile', 'rubbish heap', 'junk heap', 'trash mountain', 'trash deal', 'trash stack']
tube form	['tube frame', 'tube shape', 'tube chassis', 'tube make', 'tube phase', 'tube configuration', 'tube spring']
twin brothers	['twin brother', 'twin Brother', 'Twin brothers', 'couple brothers', 'Gemini brothers', 'mate brothers', 'match brothers']
unbroken period	['unbroken flow', 'kept period', 'unbroken point', 'unploughed period', 'unplowed period', 'unbroken catamenia', 'unbroken geologicalperiod']
undulating course	['undulating line', 'undulating path', 'undulating track', 'undulating form', 'wave course', 'roll course', 'undulating run']
universe humans	['universe world', 'world humans', 'universe human', 'universe man', 'universe mankind', 'creation humans', 'universe humanity']
user interfaces	['user interface', 'user port', 'user userinterface', 'substanceabuser interfaces', 'exploiter interfaces', 'druguser interfaces']
vantage point	['advantage point', 'vantage direct', 'vantage show', 'vantage spot', 'vantage place', 'vantage level', 'vantage item']
vantage point	['advantage point', 'vantage direct', 'vantage show', 'vantage spot', 'vantage place', 'vantage level', 'vantage item']
vector space	['vector distance', 'vector quad', 'vector blank', 'vector infinite', 'transmitter space', 'vector place', 'vector blankspace']
vice president	['vice President', 'vice chairman', 'vice chair', 'vice chairperson', 'vice chairwoman', 'vice prexy', 'frailty president']
video game	['TV game', 'video back', 'television game', 'picture game', 'video biz', 'video plot', 'video gamey']
video history	['television history', 'video story', 'TV history', 'video account', 'picture history', 'video chronicle', 'videorecording history']
video output	['video production', 'TV output', 'television output', 'picture output', 'video yield', 'video turnout', 'videorecording output']
village development	['Village development', 'settlement development', 'village growth', 'village growing', 'hamlet development', 'village developing', 'village evolution']
voice control	['sound control', 'voice command', 'voice see', 'voice master', 'voice check', 'part control', 'voice hold']
voice mail	['voice post', 'voice send', 'part mail', 'sound mail', 'representative mail', 'articulation mail', 'interpreter mail']
voice recognition	['voice identification', 'sound recognition', 'part recognition', 'voice credit', 'representative recognition', 'voice acknowledgement', 'articulation recognition']
waste water	['wild water', 'runoff water', 'ware water', 'consume water', 'rot water', 'blow water', 'wasteland water']
water pollution	['water contamination', 'H2O pollution', 'weewee pollution', 'bodyofwater pollution', 'pee pollution', 'watersystem pollution', 'piss pollution']
web application	['net application', 'network application', 'WWW application', 'web coating', 'web covering', 'WorldWideWeb application', 'web diligence']
web forms	['web form', 'web work', 'web cast', 'web make', 'web course', 'net forms', 'web build']
wedding feast	['wedding banquet', 'marriage feast', 'wedding spread', 'wedding fete', 'wedding feed', 'wedding fiesta', 'wed feast']
wedding feast	['wedding banquet', 'marriage feast', 'wedding spread', 'wedding fete', 'wedding feed', 'wedding fiesta', 'wed feast']
wedding preparations	['wedding planning', 'wedding preparation', 'wedding cooking', 'wedding prep', 'wedding grooming', 'wedding training', 'marriage preparations']
wedding ring	['wedding band', 'tie ring', 'marriage ring', 'wedding phone', 'wedding pack', 'wedding call', 'wedding knell']
weight loss	['weight release', 'weight going', 'weight red', 'burden loss', 'weight deprivation', 'weight passing', 'weightiness loss']
west side	['West side', 'W side', 'west slope', 'west face', 'west English', 'west position', 'westward side']
west side	['West side', 'W side', 'west slope', 'west face', 'west English', 'west position', 'westward side']
wind power	['wind force', 'lead power', 'lift power', 'wind might', 'roll power', 'tip power', 'wrap power']
wind sensors	['wind sensor', 'wind detector', 'thread sensors', 'nose sensors', 'tip sensors', 'wrap sensors', 'roll sensors']
winning competitor	['winning competition', 'winning contender', 'winning rival', 'acquire competitor', 'winning challenger', 'win competitor', 'victorious competitor']
wish list	['want list', 'like list', 'bid list', 'care list', 'wish name', 'wish number', 'wish listing']
worker rights	['worker right', 'worker compensate', 'proletarian rights', 'prole rights', 'doer rights', 'actor rights', 'worker rectify']
world champion	['world champ', 'world star', 'world hero', 'world friend', 'man champion', 'global champion', 'world ace']
world tour	['world go', 'world circuit', 'public tour', 'global tour', 'reality tour', 'worldwide tour', 'worldwide tour']
wrestling credentials	['grappling credentials', 'wrestling certificate', 'wrestling credential', 'wrestling certification', 'rassling credentials', 'worm credentials', 'wriggle credentials']
writing style	['writing mode', 'pen style', 'save style', 'write style', 'writing title', 'writing way', 'composition style']
writing system	['writing organization', 'save system', 'write system', 'pen system', 'writing arrangement', 'composition system', 'spell system']
youth crime	['young crime', 'youth offense', 'youth offence', 'springchicken crime', 'earlydays crime', 'younker crime', 'juvenility crime']
youth group	['young group', 'youth radical', 'youth grouping', 'springchicken group', 'earlydays group', 'younker group', 'juvenility group']
youth group	['young group', 'youth radical', 'youth grouping', 'springchicken group', 'earlydays group', 'younker group', 'juvenility group']
youth hostel	['youth lodge', 'youth inn', 'young hostel', 'springchicken hostel', 'earlydays hostel', 'younker hostel', 'juvenility hostel']
air force	['air pressure', 'air power', 'air drive', 'strain force', 'air ram', 'air storm', 'line force']
air force	['air pressure', 'air power', 'air drive', 'strain force', 'air ram', 'air storm', 'line force']
arcade game	['arcade back', 'arcade plot', 'arcade biz', 'arcade lame', 'colonnade game', 'arcade secretplan', 'arcade halt']
arcade game	['arcade back', 'arcade plot', 'arcade biz', 'arcade lame', 'colonnade game', 'arcade secretplan', 'arcade halt']
bone marrow	['bone heart', 'bone meat', 'bone center', 'bone substance', 'bone core', 'bone essence', 'bone pith']
bone marrow	['bone heart', 'bone meat', 'bone center', 'bone substance', 'bone core', 'bone essence', 'bone pith']
bounty hunter	['Bounty hunter', 'bounty Hunter', 'premium hunter', 'bounty Orion', 'amplitude hunter', 'HMSBounty hunter', 'bountifulness hunter']
bounty hunter	['Bounty hunter', 'bounty Hunter', 'premium hunter', 'bounty Orion', 'amplitude hunter', 'HMSBounty hunter', 'bountifulness hunter']
brand image	['post image', 'brand see', 'make image', 'brand double', 'brand project', 'brand icon', 'brand range']
brand image	['post image', 'brand see', 'make image', 'brand double', 'brand project', 'brand icon', 'brand range']
brand name	['post name', 'brand list', 'trademark name', 'make name', 'brand make', 'brand gens', 'mark name']
brand name	['post name', 'brand list', 'trademark name', 'make name', 'brand make', 'brand gens', 'mark name']
call centre	['call center', 'Call centre', 'call Centre', 'address centre', 'call heart', 'name centre', 'call core']
call centre	['call center', 'Call centre', 'call Centre', 'address centre', 'call heart', 'name centre', 'call core']
capital crime	['capital offense', 'Capital crime', 'great crime', 'capital offence', 'Washington crime', 'cap crime', 'capitalletter crime']
capital crime	['capital offense', 'Capital crime', 'great crime', 'capital offence', 'Washington crime', 'cap crime', 'capitalletter crime']
cast iron	['casting iron', 'project iron', 'form iron', 'cast press', 'roll iron', 'cat iron', 'put iron']
cast iron	['casting iron', 'project iron', 'form iron', 'cast press', 'roll iron', 'cat iron', 'put iron']
con man	['con Man', 'sting man', 'con world', 'learn man', 'scam man', 'flimflam man', 'hustle man']
con man	['con Man', 'sting man', 'con world', 'learn man', 'scam man', 'flimflam man', 'hustle man']
confidence bounds	['confidence limit', 'confidence bound', 'confidence jump', 'confidence edge', 'confidence bounce', 'confidence spring', 'confidence boundary']
confidence bounds	['confidence limit', 'confidence bound', 'confidence jump', 'confidence edge', 'confidence bounce', 'confidence spring', 'confidence boundary']
cover letter	['covering letter', 'report letter', 'back letter', 'top letter', 'binding letter', 'address letter', 'cross letter']
cover letter	['covering letter', 'report letter', 'back letter', 'top letter', 'binding letter', 'address letter', 'cross letter']
cover song	['top song', 'report song', 'cover Song', 'track song', 'back song', 'cover call', 'screen song']
cover song	['top song', 'report song', 'cover Song', 'track song', 'back song', 'cover call', 'screen song']
cover story	['top story', 'back story', 'report story', 'cover floor', 'cover report', 'screen story', 'cover history']
cover story	['top story', 'back story', 'report story', 'cover floor', 'cover report', 'screen story', 'cover history']
cruise lines	['cruise line', 'cruise air', 'cruise business', 'cruise job', 'cruise note', 'cruise cable', 'cruise course']
cult film	['cult movie', 'cult cinema', 'cult flick', 'cult take', 'craze film', 'cult picture', 'rage film']
dirt road	['soil road', 'crap road', 'dirt route', 'grunge road', 'grease road', 'grime road', 'ungraded road']
domain name	['field name', 'area name', 'domain list', 'world name', 'domain make', 'domain key', 'domain identify']
domain name	['field name', 'area name', 'domain list', 'world name', 'domain make', 'domain key', 'domain identify']
draft pick	['draft choice', 'draft selection', 'draft option', 'draft clean', 'draft piece', 'draft picking', 'outline pick']
draft pick	['draft choice', 'draft selection', 'draft option', 'draft clean', 'draft piece', 'draft picking', 'outline pick']
dress code	['set code', 'do code', 'trim code', 'clip code', 'clothes code', 'groom code', 'coiffure code']
drug lord	['drug Lord', 'drug Maker', 'drug master', 'drug overlord', 'dose lord', 'drug Creator', 'dodrugs lord']
drug lord	['drug Lord', 'drug Maker', 'drug master', 'drug overlord', 'dose lord', 'drug Creator', 'dodrugs lord']
family ties	['family association', 'family link', 'family connect', 'family bond', 'home ties', 'family tie', 'family wed']
family ties	['family association', 'family link', 'family connect', 'family bond', 'home ties', 'family tie', 'family wed']
field work	['field study', 'study work', 'field crop', 'area work', 'domain work', 'field form', 'field make']
field work	['field study', 'study work', 'field crop', 'area work', 'domain work', 'field form', 'field make']
fire drill	['can drill', 'fire exercise', 'fire practice', 'attack drill', 'firing drill', 'blast drill', 'raise drill']
fire drill	['can drill', 'fire exercise', 'fire practice', 'attack drill', 'firing drill', 'blast drill', 'raise drill']
flash flood	['cheap flood', 'instant flood', 'flash torrent', 'flash deluge', 'flare flood', 'flashbulb flood', 'flashbulb flood']
flash flood	['cheap flood', 'instant flood', 'flash torrent', 'flash deluge', 'flare flood', 'flashbulb flood', 'flashbulb flood']
flip book	['flip Book', 'pass book', 'leaf book', 'pitch book', 'flick book', 'sky book', 'alternate book']
flip book	['flip Book', 'pass book', 'leaf book', 'pitch book', 'flick book', 'sky book', 'alternate book']
founding fathers	['founding Father', 'founding father', 'founding mother', 'found fathers', 'founding sire', 'founding founder', 'foundation fathers']
founding fathers	['founding Father', 'founding father', 'founding mother', 'found fathers', 'founding sire', 'founding founder', 'foundation fathers']
frame story	['frame level', 'frame report', 'frame floor', 'put story', 'cast story', 'form story', 'build story']
frame story	['frame level', 'frame report', 'frame floor', 'put story', 'cast story', 'form story', 'build story']
green card	['Green card', 'common card', 'green board', 'jet card', 'green bill', 'green menu', 'green poster']
green card	['Green card', 'common card', 'green board', 'jet card', 'green bill', 'green menu', 'green poster']
guest appearance	['Guest appearance', 'guest show', 'guest appearing', 'node appearance', 'client appearance', 'invitee appearance', 'EdgarAlbertGuest appearance']
guest appearance	['Guest appearance', 'guest show', 'guest appearing', 'node appearance', 'client appearance', 'invitee appearance', 'EdgarAlbertGuest appearance']
guest book	['Guest book', 'guest Book', 'client book', 'guest record', 'guest reserve', 'guest Word', 'node book']
guest book	['Guest book', 'guest Book', 'client book', 'guest record', 'guest reserve', 'guest Word', 'node book']
guest star	['Guest star', 'guest starring', 'client star', 'guest genius', 'guest lead', 'guest principal', 'guest leading']
guest star	['Guest star', 'guest starring', 'client star', 'guest genius', 'guest lead', 'guest principal', 'guest leading']
hip roof	['hip cap', 'hip ceiling', 'rosehip roof', 'hipjoint roof', 'pelvicarch roof', 'articulatiocoxae roof', 'rosehip roof']
hip roof	['hip cap', 'hip ceiling', 'rosehip roof', 'hipjoint roof', 'pelvicarch roof', 'articulatiocoxae roof', 'rosehip roof']
junk food	['dust food', 'trash food', 'rubble food', 'debris food', 'scrap food', 'detritus food', 'junk nutrient']
junk food	['dust food', 'trash food', 'rubble food', 'debris food', 'scrap food', 'detritus food', 'junk nutrient']
love life	['enjoy life', 'dear life', 'love living', 'know life', 'love spirit', 'jazz life', 'love animation']
love life	['enjoy life', 'dear life', 'love living', 'know life', 'love spirit', 'jazz life', 'love animation']
machine learning	['machine check', 'machine see', 'machine read', 'machine take', 'machine learn', 'machine watch', 'auto learning']
machine learning	['machine check', 'machine see', 'machine read', 'machine take', 'machine learn', 'machine watch', 'auto learning']
mass media	['Mass media', 'mountain media', 'people media', 'deal media', 'mass medium', 'bulk media', 'volume media']
mass media	['Mass media', 'mountain media', 'people media', 'deal media', 'mass medium', 'bulk media', 'volume media']
master plan	['original plan', 'control plan', 'master program', 'master programme', 'master project', 'master design', 'professional plan']
master plan	['original plan', 'control plan', 'master program', 'master programme', 'master project', 'master design', 'professional plan']
navy blue	['Navy blue', 'navy dark', 'navy low', 'navy down', 'USN blue', 'darkblue blue', 'navy sorry']
navy blue	['Navy blue', 'navy dark', 'navy low', 'navy down', 'USN blue', 'darkblue blue', 'navy sorry']
nursery stock	['nursery store', 'greenhouse stock', 'nursery standard', 'nursery line', 'nursery inventory', 'nursery livestock', 'nursery sprout']
panic attack	['terror attack', 'panic assault', 'panic fire', 'panic round', 'panic attempt', 'scare attack', 'affright attack']
panic attack	['terror attack', 'panic assault', 'panic fire', 'panic round', 'panic attempt', 'scare attack', 'affright attack']
pepper spray	['pepper spraying', 'capsicum spray', 'pepper sprayer', 'commonpepper spray', 'pelt spray', 'blackpepper spray', 'whitepepper spray']
pepper spray	['pepper spraying', 'capsicum spray', 'pepper sprayer', 'commonpepper spray', 'pelt spray', 'blackpepper spray', 'whitepepper spray']
pit stop	['pit bar', 'Hell stop', 'stone stop', 'mark stop', 'match stop', 'pit check', 'pit closure']
pit stop	['pit bar', 'Hell stop', 'stone stop', 'mark stop', 'match stop', 'pit check', 'pit closure']
power base	['force base', 'power home', 'index base', 'power Base', 'mogul base', 'power infrastructure', 'power ground']
rush hour	['Rush hour', 'rush minute', 'charge hour', 'rush hr', 'rushed hour', 'flush hour', 'speed hour']
rush hour	['Rush hour', 'rush minute', 'charge hour', 'rush hr', 'rushed hour', 'flush hour', 'speed hour']
salary cap	['earnings cap', 'pay cap', 'wage cap', 'salary ceiling', 'salary capital', 'remuneration cap', 'salary roof']
salary cap	['earnings cap', 'pay cap', 'wage cap', 'salary ceiling', 'salary capital', 'remuneration cap', 'salary roof']
search engine	['research engine', 'lookup engine', 'seek engine', 'look engine', 'search locomotive', 'explore engine', 'hunt engine']
side effect	['side event', 'side issue', 'position effect', 'side force', 'side setup', 'side result', 'face effect']
signal box	['point box', 'signal corner', 'sign box', 'signal package', 'indicate box', 'signaling box', 'signalize box']
signal box	['point box', 'signal corner', 'sign box', 'signal package', 'indicate box', 'signaling box', 'signalize box']
tax base	['tax Base', 'tax foundation', 'tax home', 'tax basis', 'tax infrastructure', 'tax ground', 'task base']
tax base	['tax Base', 'tax foundation', 'tax home', 'tax basis', 'tax infrastructure', 'tax ground', 'task base']
theme park	['theme Park', 'theme green', 'theme common', 'report park', 'paper park', 'topic park', 'subject park']
theme park	['theme Park', 'theme green', 'theme common', 'report park', 'paper park', 'topic park', 'subject park']
time line	['time job', 'time business', 'time course', 'time note', 'time stock', 'time air', 'time origin']
time line	['time job', 'time business', 'time course', 'time note', 'time stock', 'time air', 'time origin']
time trial	['time test', 'time run', 'time tribulation', 'time visitation', 'meter trial', 'time tryout', 'clock trial']
vacuum cleaner	['vacuum clean', 'vacuum light', 'hoover cleaner', 'vacuum fresh', 'vacuum white', 'vacuum blank', 'vacancy cleaner']
water park	['water Park', 'water green', 'water common', 'water commons', 'H2O park', 'piddle park', 'water parkland']
water park	['water Park', 'water green', 'water common', 'water commons', 'H2O park', 'piddle park', 'water parkland']
wind farm	['lead farm', 'lift farm', 'wind grow', 'roll farm', 'wind produce', 'hoist farm', 'wind raise']
wind farm	['lead farm', 'lift farm', 'wind grow', 'roll farm', 'wind produce', 'hoist farm', 'wind raise']
wolf pack	['Wolf pack', 'wolf gang', 'wolf camp', 'wolf ring', 'wolf take', 'wolf multitude', 'beast pack']
wolf pack	['Wolf pack', 'wolf gang', 'wolf camp', 'wolf ring', 'wolf take', 'wolf multitude', 'beast pack']
word processor	['Word processor', 'password processor', 'news processor', 'word mainframe', 'word CPU', 'word CPU', 'Book processor']
word processor	['Word processor', 'password processor', 'news processor', 'word mainframe', 'word CPU', 'word CPU', 'Book processor']
world record	['public record', 'world book', 'world read', 'world show', 'world register', 'world enter', 'world disc']
youth wing	['youth fly', 'youth extension', 'youth annex', 'young wing', 'youth fender', 'springchicken wing', 'earlydays wing']
youth wing	['youth fly', 'youth extension', 'youth annex', 'young wing', 'youth fender', 'springchicken wing', 'earlydays wing']
academy award	['academy grant', 'academy prize', 'academy honor', 'academy present', 'academy awarding', 'academy accolade', 'academy honour']
action figure	['action project', 'action name', 'action see', 'action form', 'action number', 'action design', 'action picture']
band aid	['band help', 'band assist', 'band care', 'band attention', 'band assistance', 'lot aid', 'set aid']
battle cry	['battle call', 'battle shout', 'fight cry', 'battle yell', 'conflict cry', 'battle scream', 'struggle cry']
battle cry	['battle call', 'battle shout', 'fight cry', 'battle yell', 'conflict cry', 'battle scream', 'struggle cry']
blank shells	['blank plate', 'white shells', 'blank shell', 'blank case', 'clean shells', 'blank shield', 'blank blast']
blank shells	['blank plate', 'white shells', 'blank shell', 'blank case', 'clean shells', 'blank shield', 'blank blast']
blood bath	['blood Bath', 'line bath', 'stock bath', 'blood tub', 'blood bathroom', 'blood bathe', 'rip bath']
body whorl	['body roll', 'body scroll', 'body coil', 'body lock', 'body curl', 'body spiral', 'body helix']
box office	['corner office', 'box post', 'box part', 'box power', 'box function', 'box place', 'package office']
box office	['corner office', 'box post', 'box part', 'box power', 'box function', 'box place', 'package office']
brain drain	['head drain', 'mind drain', 'brain drainage', 'mentality drain', 'genius drain', 'encephalon drain', 'Einstein drain']
brass knuckles	['brass knuckle', 'brass knucks', 'face knuckles', 'brassinstrument knuckles', 'governance knuckles', 'memorialtablet knuckles', 'organisation knuckles']
break point	['check point', 'breaking point', 'split point', 'stop point', 'break guide', 'better point', 'part point']
break point	['check point', 'breaking point', 'split point', 'stop point', 'break guide', 'better point', 'part point']
bull market	['Bull market', 'copper market', 'pig market', 'fake market', 'bull grocery', 'Taurus market', 'crap market']
business park	['business Park', 'business green', 'business common', 'line park', 'concern park', 'business commons', 'job park']
cadet branch	['plebe branch', 'cadet ramify', 'cadet furcate', 'cadet subdivision', 'cadet ramification', 'cadet separate', 'cadet limb']
cadet branch	['plebe branch', 'cadet ramify', 'cadet furcate', 'cadet subdivision', 'cadet ramification', 'cadet separate', 'cadet limb']
capital market	['Capital market', 'great market', 'Washington market', 'cap market', 'capital marketplace', 'capital marketplace', 'capitalletter market']
capital punishment	['Capital punishment', 'great punishment', 'capital penalty', 'cap punishment', 'Washington punishment', 'capitalletter punishment', 'uppercase punishment']
case law	['case police', 'subject law', 'type law', 'event law', 'example law', 'cause law', 'lawsuit law']
cash crop	['Cash crop', 'cash work', 'cash harvest', 'cash browse', 'cash dress', 'cash clip', 'cash range']
cat fight	['CAT fight', 'cat press', 'cat fighting', 'guy fight', 'cat campaign', 'cat battle', 'cat engagement']
cat fight	['CAT fight', 'cat press', 'cat fighting', 'guy fight', 'cat campaign', 'cat battle', 'cat engagement']
catch phrase	['match phrase', 'catch word', 'watch phrase', 'see phrase', 'view phrase', 'get phrase', 'stop phrase']
cell phone	['cell telephone', 'cell call', 'cell ring', 'cellphone phone', 'cell sound', 'cubicle phone', 'mobilephone phone']
chain smoker	['Chain smoker', 'range smoker', 'ErnstBorisChain smoker', 'chemicalchain smoker', 'string smoker', 'concatenation smoker', 'SirErnstBorisChain smoker']
cheek teeth	['face teeth', 'brass teeth', 'cheek tooth', 'nerve teeth', 'cheek dentition', 'impudence teeth', 'boldness teeth']
china clay	['China clay', 'china Clay', 'china remains', 'china mud', 'china stiff', 'chinaware clay', 'PRC clay']
circuit court	['circuit Court', 'tour court', 'circle court', 'circuit courtroom', 'lap court', 'circuit tribunal', 'circuit homage']
circuit court	['circuit Court', 'tour court', 'circle court', 'circuit courtroom', 'lap court', 'circuit tribunal', 'circuit homage']
command line	['control line', 'command air', 'command note', 'command argument', 'command channel', 'statement line', 'require line']
concentration camp	['immersion camp', 'concentration pack', 'absorption camp', 'assiduousness camp', 'assiduity camp', 'engrossment camp', 'compactness camp']
concentration camp	['immersion camp', 'concentration pack', 'absorption camp', 'assiduousness camp', 'assiduity camp', 'engrossment camp', 'compactness camp']
contact lens	['contact Lens', 'contact lense', 'link lens', 'touch lens', 'reach lens', 'striking lens', 'adjoin lens']
convenience store	['appliance store', 'gadget store', 'widget store', 'convenience shop', 'convenience storage', 'gizmo store', 'restroom store']
cover band	['cover set', 'top band', 'cross band', 'traverse band', 'back band', 'handle band', 'track band']
crash course	['crash class', 'crash grade', 'crash form', 'crash track', 'crash path', 'crash line', 'crash run']
day care	['Day care', 'day like', 'day deal', 'day wish', 'day maintenance', 'day fear', 'day charge']
day care	['Day care', 'day like', 'day deal', 'day wish', 'day maintenance', 'day fear', 'day charge']
death row	['Death row', 'last row', 'end row', 'death words', 'death course', 'destruction row', 'demise row']
face value	['present value', 'case value', 'expression value', 'font value', 'face rate', 'side value', 'look value']
fallen angel	['fallen Angel', 'light angel', 'come angel', 'fall angel', 'shine angel', 'fallen saint', 'return angel']
fallen angel	['fallen Angel', 'light angel', 'come angel', 'fall angel', 'shine angel', 'fallen saint', 'return angel']
family seat	['family can', 'house seat', 'class seat', 'family place', 'family behind', 'family tail', 'home seat']
family seat	['family can', 'house seat', 'class seat', 'family place', 'family behind', 'family tail', 'home seat']
family tree	['family Tree', 'class tree', 'category tree', 'home tree', 'family corner', 'house tree', 'folk tree']
feature film	['feature take', 'sport film', 'have film', 'feature flick', 'feature shoot', 'feature movie', 'feature picture']
field goal	['field end', 'study goal', 'field destination', 'area goal', 'field finish', 'discipline goal', 'subject goal']
field trip	['study trip', 'field travel', 'area trip', 'theatre trip', 'subject trip', 'theater trip', 'field activate']
field trip	['study trip', 'field travel', 'area trip', 'theatre trip', 'subject trip', 'theater trip', 'field activate']
fight song	['fight Song', 'campaign song', 'battle song', 'fight call', 'fighting song', 'contend song', 'struggle song']
fire power	['can power', 'fire king', 'fuel power', 'attack power', 'fire might', 'fire office', 'fire index']
fire power	['can power', 'fire king', 'fuel power', 'attack power', 'fire might', 'fire office', 'fire index']
flag stop	['pin stop', 'flag check', 'flag end', 'flag block', 'flag hitch', 'flag break', 'flag finish']
flash memory	['flash storage', 'flash store', 'instant memory', 'cheap memory', 'flashbulb memory', 'flashbulb memory', 'dash memory']
flash memory	['flash storage', 'flash store', 'instant memory', 'cheap memory', 'flashbulb memory', 'flashbulb memory', 'dash memory']
flea market	['flea mart', 'flea marketplace', 'flea marketplace', 'flea commercialize', 'flea foodmarket', 'flea grocerystore', 'flea grocery']
floating point	['floating head', 'floating charge', 'floating stage', 'float point', 'floating tip', 'floating level', 'floating target']
food chain	['food Chain', 'food range', 'food string', 'nutrient chain', 'food strand', 'intellectualnourishment chain', 'foodforthought chain']
food chain	['food Chain', 'food range', 'food string', 'nutrient chain', 'food strand', 'intellectualnourishment chain', 'foodforthought chain']
front line	['front air', 'front channel', 'front business', 'front seam', 'front note', 'front cable', 'look line']
front line	['front air', 'front channel', 'front business', 'front seam', 'front note', 'front cable', 'look line']
gag rule	['jape rule', 'joke rule', 'laugh rule', 'fret rule', 'gag formula', 'gag rein', 'gag harness']
ghost town	['ghost Town', 'spook town', 'shade town', 'touch town', 'specter town', 'haunt town', 'trace town']
glee club	['glee society', 'glee order', 'mirthfulness club', 'mirth club', 'gleefulness club', 'gloating club', 'gloat club']
gold rush	['gold Rush', 'gold speed', 'gold race', 'gold charge', 'gold boot', 'golden rush', 'gold surge']
goose bumps	['goose bump', 'goose find', 'goose break', 'goose chance', 'goof bumps', 'bozo bumps', 'goose knock']
grass roots	['Grass roots', 'grass root', 'grass theme', 'grass source', 'shop roots', 'weed roots', 'grass stem']
greenhouse gas	['greenhouse gasoline', 'nursery gas', 'greenhouse accelerator', 'greenhouse gun', 'greenhouse petrol', 'glasshouse gas', 'greenhouse gasconade']
ground rule	['ground find', 'base rule', 'ground pattern', 'labor rule', 'reason rule', 'land rule', 'basis rule']
guinea pig	['Guinea pig', 'guinea hog', 'guinea bull', 'guinea copper', 'greaseball pig', 'wop pig', 'Numidameleagris pig']
gun dog	['gun tag', 'gun click', 'gas dog', 'gun track', 'shooter dog', 'gun frank', 'gun heel']
hard core	['hard CORE', 'strong core', 'hard heart', 'hard substance', 'hard kernel', 'hard center', 'heavy core']
hard disk	['hard disc', 'heavy disk', 'difficult disk', 'tough disk', 'hard record', 'strong disk', 'arduous disk']
hard drive	['hard labor', 'hard labour', 'hard driving', 'hard ride', 'strong drive', 'hard get', 'hard take']
heat wave	['heat Wave', 'heat roll', 'heat curl', 'heating wave', 'wake wave', 'passion wave', 'heat waving']
heavy metal	['large metal', 'hard metal', 'big metal', 'great metal', 'heavy alloy', 'dense metal', 'heavy metallic']
heavy metal	['large metal', 'hard metal', 'big metal', 'great metal', 'heavy alloy', 'dense metal', 'heavy metallic']
high school	['heights school', 'high train', 'high schooling', 'highschool school', 'highschool school', 'eminent school', 'high educate']
high school	['heights school', 'high train', 'high schooling', 'highschool school', 'highschool school', 'eminent school', 'high educate']
home front	['home look', 'national front', 'home breast', 'home face', 'plate front', 'interior front', 'house front']
home ground	['home base', 'home land', 'home background', 'home earth', 'home soil', 'home labor', 'home found']
home ground	['home base', 'home land', 'home background', 'home earth', 'home soil', 'home labor', 'home found']
home run	['home work', 'family run', 'home guide', 'home course', 'home go', 'home test', 'home play']
home run	['home work', 'family run', 'home guide', 'home course', 'home go', 'home test', 'home play']
house arrest	['house hold', 'house get', 'house check', 'home arrest', 'house stay', 'house stop', 'house catch']
house arrest	['house hold', 'house get', 'house check', 'home arrest', 'house stay', 'house stop', 'house catch']
hype man	['hype Man', 'hype world', 'plug man', 'ballyhoo man', 'hype humanity', 'hype piece', 'hoopla man']
injury time	['trauma time', 'hurt time', 'wound time', 'harm time', 'injury clip', 'injury sentence', 'combatinjury time']
injury time	['trauma time', 'hurt time', 'wound time', 'harm time', 'injury clip', 'injury sentence', 'combatinjury time']
jet lag	['green lag', 'K lag', 'jet meanwhile', 'bluejet lag', 'superacid lag', 'jetblack lag', 'superC lag']
lady chapel	['Lady chapel', 'dame chapel', 'peeress chapel', 'noblewoman chapel', 'madam chapel', 'gentlewoman chapel', 'maam chapel']
lady chapel	['Lady chapel', 'dame chapel', 'peeress chapel', 'noblewoman chapel', 'madam chapel', 'gentlewoman chapel', 'maam chapel']
lead time	['take time', 'run time', 'go time', 'track time', 'pass time', 'top time', 'leave time']
leaf spring	['leaf form', 'thumb spring', 'foliage spring', 'leaf bound', 'leaf fountain', 'riffle spring', 'flick spring']
leap year	['spring year', 'jump year', 'bound year', 'leap yr', 'leap class', 'leaping year', 'bounce year']
leap year	['spring year', 'jump year', 'bound year', 'leap yr', 'leap class', 'leaping year', 'bounce year']
life cycle	['life bicycle', 'life motorcycle', 'life round', 'life bike', 'life wheel', 'life rhythm', 'animation cycle']
lift hill	['lift Hill', 'cabbage hill', 'hook hill', 'wind hill', 'abstract hill', 'rear hill', 'rise hill']
love triangle	['love Triangle', 'know triangle', 'dear triangle', 'enjoy triangle', 'honey triangle', 'passion triangle', 'beloved triangle']
love triangle	['love Triangle', 'know triangle', 'dear triangle', 'enjoy triangle', 'honey triangle', 'passion triangle', 'beloved triangle']
lump sum	['lump amount', 'lump meat', 'lump add', 'lump core', 'ball sum', 'lump total', 'lump heart']
lump sum	['lump amount', 'lump meat', 'lump add', 'lump core', 'ball sum', 'lump total', 'lump heart']
machine gun	['auto gun', 'machine gas', 'car gun', 'machine hitman', 'machine hitman', 'machine gunman', 'machine accelerator']
machine gun	['auto gun', 'machine gas', 'car gun', 'machine hitman', 'machine hitman', 'machine gunman', 'machine accelerator']
mind map	['mind mapping', 'head map', 'brain map', 'idea map', 'mind function', 'mind represent', 'listen map']
morning glory	['dawning glory', 'morning halo', 'dawn glory', 'sunrise glory', 'morn glory', 'aurora glory', 'daybreak glory']
mother tongue	['get tongue', 'father tongue', 'mother spit', 'mother knife', 'mother clapper', 'fuss tongue', 'generate tongue']
mother tongue	['get tongue', 'father tongue', 'mother spit', 'mother knife', 'mother clapper', 'fuss tongue', 'generate tongue']
nerve agent	['face agent', 'steel agent', 'heart agent', 'nerve factor', 'brass agent', 'nervus agent', 'boldness agent']
nerve agent	['face agent', 'steel agent', 'heart agent', 'nerve factor', 'brass agent', 'nervus agent', 'boldness agent']
news anchor	['news ground', 'news anchorman', 'news keystone', 'word anchor', 'news backbone', 'news mainstay', 'intelligence anchor']
open source	['subject source', 'open root', 'open reference', 'loose source', 'clear source', 'surface source', 'open author']
operating system	['control system', 'lock system', 'operational system', 'go system', 'work system', 'run system', 'function system']
optical fiber	['optical character', 'optical fibre', 'optic fiber', 'visual fiber', 'ocular fiber', 'opthalmic fiber', 'optical vulcanizedfiber']
pen name	['write name', 'pen make', 'pen key', 'pen list', 'pen call', 'pen describe', 'compose name']
pen name	['write name', 'pen make', 'pen key', 'pen list', 'pen call', 'pen describe', 'compose name']
people skills	['people science', 'people skill', 'people acquisition', 'people accomplishment', 'masses skills', 'citizenry skills', 'multitude skills']
people skills	['people science', 'people skill', 'people acquisition', 'people accomplishment', 'masses skills', 'citizenry skills', 'multitude skills']
pig iron	['copper iron', 'pig press', 'bull iron', 'raven iron', 'cop iron', 'hog iron', 'grunter iron']
point guard	['point safety', 'head guard', 'point hold', 'point defend', 'tip guard', 'level guard', 'stop guard']
position paper	['view paper', 'office paper', 'position report', 'placement paper', 'set paper', 'place paper', 'perspective paper']
position paper	['view paper', 'office paper', 'position report', 'placement paper', 'set paper', 'place paper', 'perspective paper']
power train	['power take', 'power school', 'power check', 'power gear', 'power direct', 'power rail', 'power discipline']
price point	['price guide', 'Price point', 'price level', 'price item', 'price target', 'price show', 'price stop']
quarter section	['tail section', 'fourth section', 'quarter part', 'stern section', 'quarter department', 'draw section', 'quarter segment']
quarter section	['tail section', 'fourth section', 'quarter part', 'stern section', 'quarter department', 'draw section', 'quarter segment']
rain forest	['rain wood', 'rainfall forest', 'rain woods', 'rain woodland', 'rain timberland', 'rainwater forest', 'raindown forest']
real estate	['actual estate', 'genuine estate', 'real land', 'substantial estate', 'tangible estate', 'material estate', 'real acres']
real estate	['actual estate', 'genuine estate', 'real land', 'substantial estate', 'tangible estate', 'material estate', 'real acres']
role model	['use model', 'role modeling', 'role simulation', 'part model', 'character model', 'function model', 'office model']
roll cage	['roll Cage', 'wheel cage', 'roller cage', 'range cage', 'bun cage', 'rolling cage', 'bowl cage']
roll cage	['roll Cage', 'wheel cage', 'roller cage', 'range cage', 'bun cage', 'rolling cage', 'bowl cage']
roller coaster	['roll coaster', 'curler coaster', 'haircurler coaster', 'tumbler coaster', 'crimper coaster', 'rollingwave coaster', 'tumblerpigeon coaster']
roller coaster	['roll coaster', 'curler coaster', 'haircurler coaster', 'tumbler coaster', 'crimper coaster', 'rollingwave coaster', 'tumblerpigeon coaster']
round trip	['round travel', 'round trigger', 'round tripper', 'circle trip', 'cycle trip', 'beat trip', 'round slip']
round trip	['round travel', 'round trigger', 'round tripper', 'circle trip', 'cycle trip', 'beat trip', 'round slip']
sex life	['gender life', 'sexuality life', 'sex living', 'sex spirit', 'sex animation', 'sex lifetime', 'sex lifetime']
shelf life	['shelf biography', 'shelf living', 'shelf lifetime', 'shelf lifetime', 'ledge life', 'shelf animation', 'shelf lifespan']
shock wave	['shock Wave', 'blow wave', 'impact wave', 'shock curl', 'floor wave', 'shock roll', 'cushion wave']
shock wave	['shock Wave', 'blow wave', 'impact wave', 'shock curl', 'floor wave', 'shock roll', 'cushion wave']
shot put	['shot set', 'film put', 'take put', 'flash put', 'scene put', 'charge put', 'hit put']
side kick	['side bang', 'side plain', 'face kick', 'side kicking', 'side charge', 'side boot', 'side rush']
silver age	['silver years', 'Ag age', 'silver mature', 'eloquent age', 'argent age', 'atomicnumber47 age', 'ashgray age']
sister ship	['Sister ship', 'sister send', 'baby ship', 'sister transport', 'sis ship', 'babe ship', 'sister embark']
sister ship	['Sister ship', 'sister send', 'baby ship', 'sister transport', 'sis ship', 'babe ship', 'sister embark']
snub cube	['cut cube', 'snub block', 'disregard cube', 'repulse cube', 'ignore cube', 'repel cube', 'coldshoulder cube']
soap opera	['soap Opera', 'max opera', 'liquidecstasy opera', 'goop opera', 'Georgiahomeboy opera', 'easylay opera', 'lather opera']
soft drink	['easy drink', 'soft drinking', 'soft beverage', 'delicate drink', 'soft toast', 'mild drink', 'gentle drink']
soul mate	['soul partner', 'soul twin', 'soul match', 'someone mate', 'person mate', 'soul pair', 'individual mate']
soul mate	['soul partner', 'soul twin', 'soul match', 'someone mate', 'person mate', 'soul pair', 'individual mate']
space race	['distance race', 'place race', 'space speed', 'space run', 'space rush', 'quad race', 'blank race']
speed bump	['speed hump', 'speed find', 'rush bump', 'speed break', 'speed blow', 'speed extrusion', 'upper bump']
speed bump	['speed hump', 'speed find', 'rush bump', 'speed break', 'speed blow', 'speed extrusion', 'upper bump']
splinter group	['breakaway group', 'splinter grouping', 'sliver group', 'secede group', 'splinter radical', 'splinter chemicalgroup', 'splinter aggroup']
square root	['square base', 'square theme', 'square stem', 'square ascendant', 'square solution', 'square source', 'square beginning']
stage name	['level name', 'present name', 'point name', 'stage make', 'degree name', 'stage key', 'stage list']
star shell	['star scale', 'star case', 'star shield', 'star beat', 'star plate', 'prima shell', 'star blast']
stick figure	['stick frame', 'stick see', 'stick form', 'stick design', 'stick shape', 'stick number', 'stick chassis']
stick figure	['stick frame', 'stick see', 'stick form', 'stick design', 'stick shape', 'stick number', 'stick chassis']
stop word	['break word', 'stop news', 'end word', 'check word', 'stop Word', 'catch word', 'point word']
story arc	['narrative arc', 'story arch', 'report arc', 'story spark', 'tale arc', 'history arc', 'story bow']
story line	['story business', 'level line', 'story note', 'story air', 'history line', 'report line', 'story job']
story line	['story business', 'level line', 'story note', 'story air', 'history line', 'report line', 'story job']
straw man	['straw Man', 'wheat man', 'straw world', 'straw piece', 'stalk man', 'stubble man', 'straw human']
straw poll	['wheat poll', 'straw crown', 'straw canvas', 'paleyellow poll', 'husk poll', 'stubble poll', 'stalk poll']
sun screen	['Sun screen', 'sun shield', 'sun cover', 'sun blind', 'Sunday screen', 'sun test', 'sun sort']
supporting act	['support act', 'supporting work', 'back act', 'bear act', 'supporting turn', 'supporting do', 'stand act']
sweat pants	['sweat pant', 'lather pants', 'perspire pants', 'sweat trouser', 'sweat heave', 'effort pants', 'exertion pants']
sweat pants	['sweat pant', 'lather pants', 'perspire pants', 'sweat trouser', 'sweat heave', 'effort pants', 'exertion pants']
tag line	['tag business', 'tag air', 'label line', 'tag note', 'ticket line', 'tag stock', 'tag job']
tag line	['tag business', 'tag air', 'label line', 'tag note', 'ticket line', 'tag stock', 'tag job']
tag team	['track team', 'dog team', 'chase team', 'trail team', 'mark team', 'ticket team', 'label team']
tax haven	['tax harbor', 'tax harbour', 'assess haven', 'taxation haven', 'tax oasis', 'revenueenhancement haven', 'task haven']
teddy bear	['teddy birth', 'teddy have', 'teddy carry', 'teddy hold', 'shift bear', 'slip bear', 'teddybear bear']
teddy bear	['teddy birth', 'teddy have', 'teddy carry', 'teddy hold', 'shift bear', 'slip bear', 'teddybear bear']
think tank	['consider tank', 'guess tank', 'believe tank', 'mean tank', 'remember tank', 'think cooler', 'reckon tank']
time frame	['time put', 'time setup', 'time build', 'time form', 'time figure', 'time cast', 'clip frame']
top dog	['top click', 'lead dog', 'top track', 'top tag', 'crown dog', 'cover dog', 'peak dog']
top dog	['top click', 'lead dog', 'top track', 'top tag', 'crown dog', 'cover dog', 'peak dog']
top notch	['top nick', 'top pass', 'pass notch', 'peak notch', 'height notch', 'clear notch', 'top snick']
top notch	['top nick', 'top pass', 'pass notch', 'peak notch', 'height notch', 'clear notch', 'top snick']
trust fund	['hope fund', 'bank fund', 'trust store', 'trust stock', 'reliance fund', 'faith fund', 'believe fund']
trust fund	['hope fund', 'bank fund', 'trust store', 'trust stock', 'reliance fund', 'faith fund', 'believe fund']
umbrella organization	['umbrella organisation', 'umbrella system', 'umbrella arrangement', 'umbrella formation', 'umbrella governance', 'umbrella brass', 'umbrella administration']
umbrella term	['umbrella condition', 'umbrella fullterm', 'umbrella terminus', 'umbrella terminalfigure']
zip code	['ZIP code', 'energy code', 'null code', 'speed code', 'zero code', 'nothing code', 'zip encrypt']
school record	['school book', 'school read', 'school show', 'school register', 'school enter', 'school tape', 'school disc']
debit card	['debit bill', 'debit notice', 'debit posting', 'debit carte', 'debit board', 'debit poster', 'debitentry card']
debut album	['introduction album', 'launching album', 'entry album', 'unveiling album', 'firstappearance album', 'debut recordalbum']
employment contract	['employment press', 'employment get', 'work contract', 'employment sign', 'use contract', 'usage contract', 'employment take']
touch screen	['contact screen', 'touch test', 'touch cover', 'match screen', 'signature screen', 'touch shield', 'touch sort']
acting course	['acting class', 'work course', 'play course', 'acting form', 'do course', 'act course', 'acting naturally']
action film	['action movie', 'action take', 'action flick', 'action shoot', 'action picture', 'action cinema', 'process film']
animal bones	['animal bone', 'animal castanets', 'animal pearl', 'animal drum', 'animal ivory', 'creature bones', 'fauna bones']
animal life	['animal spirit', 'animal living', 'animal animation', 'sensual life', 'creature life', 'carnal life', 'fleshly life']
approval requirements	['approval requirement', 'approval necessary', 'approval prerequisite', 'approval essential', 'approval requisite', 'approval demand', 'approving requirements']
army officer	['Army officer', 'USA officer', 'USArmy officer', 'UnitedStatesArmy officer', 'USArmy officer', 'groundforces officer', 'regulararmy officer']
art school	['graphics school', 'art train', 'artwork school', 'art schooling', 'artistry school', 'art educate', 'art schoolhouse']
ice cube	['ICE cube', 'glass cube', 'ice block', 'ice dice', 'chalk cube', 'frost cube', 'frappe cube']
intelligence officer	['news officer', 'word officer', 'intelligenceactivity officer', 'intelligenceoperation officer', 'intelligenceservice officer', 'intelligenceagency officer', 'intelligenceinformation officer']
bomb burst	['bomb explosion', 'bomb break', 'bomb explode', 'bomb bust', 'bomb split', 'bomb salvo', 'turkey burst']
access card	['access board', 'access bill', 'access menu', 'access notice', 'access plugin', 'admission card', 'access posting']
code name	['code list', 'code make', 'code key', 'code call', 'code cite', 'code refer', 'code describe']
fire brigade	['flak brigade', 'can brigade', 'burn brigade', 'attack brigade', 'sack brigade', 'openfire brigade', 'provoke brigade']
animal matter	['animal issue', 'animal thing', 'animal subject', 'brute matter', 'animal topic', 'animal weigh', 'animal affair']
drug dealer	['drug trader', 'drug principal', 'dose dealer', 'dodrugs dealer', 'drug monger', 'drug bargainer']
shock wave	['shock Wave', 'blow wave', 'impact wave', 'shock curl', 'floor wave', 'shock roll', 'cushion wave']
ice cube	['ICE cube', 'glass cube', 'ice block', 'ice dice', 'chalk cube', 'frost cube', 'frappe cube']
bomb burst	['bomb explosion', 'bomb break', 'bomb explode', 'bomb bust', 'bomb split', 'bomb salvo', 'turkey burst']
access card	['access board', 'access bill', 'access menu', 'access notice', 'access plugin', 'admission card', 'access posting']
code name	['code list', 'code make', 'code key', 'code call', 'code cite', 'code refer', 'code describe']
fire brigade	['flak brigade', 'can brigade', 'burn brigade', 'attack brigade', 'sack brigade', 'openfire brigade', 'provoke brigade']
flash memory	['flash storage', 'flash store', 'instant memory', 'cheap memory', 'flashbulb memory', 'flashbulb memory', 'dash memory']
accounting book	['account book', 'report book', 'accounting Book', 'accounting record', 'accounting ledger', 'accounting volume', 'accountancy book']
assembly line	['assembly business', 'assembly air', 'assembly cable', 'forum line', 'assembly note', 'assembly stock', 'assembly job']
automobile accident	['car accident', 'auto accident', 'machine accident', 'motorcar accident', 'automobile stroke', 'automobile fortuity', 'automobile chanceevent']
back pocket	['back bag', 'rear pocket', 'game pocket', 'stake pocket', 'cover pocket', 'binding pocket', 'back sack']
background target	['ground target', 'setting target', 'background object', 'background objective', 'background mark', 'background direct', 'background aim']
backup repository	['support repository', 'backing repository', 'backup secretary', 'backup depository', 'backup deposit', 'fillin repository', 'substitute repository']
band member	['circle member', 'set member', 'ring member', 'lot member', 'stripe member', 'isthmus member', 'banding member']
bastard son	['illegitimate son', 'bastard Son', 'shit son', 'asshole son', 'SOB son', 'bastard boy', 'fake son']
bead maker	['drop maker', 'bead Maker', 'bead manufacturer', 'pearl maker', 'bead Creator', 'bead shaper', 'bead Lord']
birth control	['have control', 'birth see', 'birth check', 'deliver control', 'bear control', 'birth command', 'birth hold']
birth defect	['birth mar', 'have defect', 'deliver defect', 'birth fault', 'birth blemish', 'birth flaw', 'parentage defect']
boat house	['boat home', 'boat family', 'boat sign', 'boat household', 'boat theatre', 'boat mansion', 'boat theater']
body language	['body speech', 'body words', 'trunk language', 'body nomenclature', 'body lyric', 'body terminology', 'consistency language']
body mass	['body Mass', 'body people', 'body mint', 'body bulk', 'body volume', 'body deal', 'body plenty']
body structure	['body construction', 'consistency structure', 'trunk structure', 'consistence structure', 'torso structure', 'deadbody structure', 'organicstructure structure']
body symmetry	['body balance', 'body proportion', 'trunk symmetry', 'body correspondence', 'torso symmetry', 'deadbody symmetry', 'organicstructure symmetry']
body wall	['trunk wall', 'body surround', 'torso wall', 'personify wall', 'body fence', 'deadbody wall', 'organicstructure wall']
bony fish	['bony Fish', 'boney fish', 'skeletal fish', 'wasted fish', 'emaciated fish', 'gaunt fish', 'haggard fish']
book review	['Book review', 'record review', 'Word review', 'book survey', 'Bible review', 'script review', 'book critique']
border guards	['border guard', 'edge guards', 'frame guards', 'border safety', 'ring guards', 'perimeter guards', 'bound guards']
bow saw	['bow view', 'bow see', 'bow watch', 'bow learn', 'bow picture', 'bow date', 'bow find']
bowl shape	['bowl SHAPE', 'bowl mold', 'bowl cast', 'bowl form', 'bowl figure', 'bowl pattern', 'bowl work']
brand awareness	['brand consciousness', 'make awareness', 'post awareness', 'mark awareness', 'stigma awareness', 'steel awareness', 'blade awareness']
breast cancer	['breast Cancer', 'chest cancer', 'boob cancer', 'summit cancer', 'bosom cancer', 'front cancer', 'breast Crab']
brightness scale	['light scale', 'luminosity scale', 'luminance scale', 'cleverness scale', 'brightness descale', 'brightnesslevel scale', 'smartness scale']
building blocks	['building block', 'construction blocks', 'building stuff', 'building stop', 'make blocks', 'building freeze', 'build blocks']
building window	['progress window', 'construction window', 'make window', 'build window', 'construct window', 'establish window', 'workup window']
burial place	['burial site', 'burial post', 'burying place', 'burial space', 'burial spot', 'burial home', 'burial office']
bus service	['bus Service', 'coach service', 'motorcoach service', 'bus serving', 'bus servicing', 'bus help', 'omnibus service']
bus types	['bus type', 'bus case', 'coach types', 'bus character', 'heap types', 'motorcoach types', 'bus eccentric']
business computer	['business calculator', 'line computer', 'job computer', 'occupation computer', 'concern computer', 'business estimator', 'clientele computer']
business deal	['business address', 'business trade', 'business conduct', 'business sell', 'business share', 'business manage', 'business take']
business model	['line model', 'business simulation', 'business modeling', 'business modelling', 'business mold', 'business example', 'business framework']
camp rules	['camp find', 'pack rules', 'camp rule', 'camp normal', 'camp convention', 'camp formula', 'tent rules']
cancer insurance	['Cancer insurance', 'cancer policy', 'cancer indemnity', 'genusCancer insurance', 'CancertheCrab insurance', 'Crab insurance', 'malignantneoplasticdisease insurance']
car maker	['car manufacturer', 'car Maker', 'auto maker', 'machine maker', 'automobile maker', 'car Lord', 'car Creator']
cast member	['form member', 'project member', 'casting member', 'roll member', 'frame member', 'cat member', 'shed member']
charge card	['send card', 'care card', 'file card', 'charge notice', 'point card', 'direction card', 'rush card']
chili pepper	['chile pepper', 'chilli pepper', 'chilly pepper', 'chili capsicum', 'chili peppercorn', 'chiliconcarne pepper', 'chilipepper pepper']
chip shop	['check shop', 'nick shop', 'chip store', 'bit shop', 'scrap shop', 'chip giveaway', 'chip browse']
chocolate manufacturer	['chocolate maker', 'coffee manufacturer', 'chocolate producer', 'cocoa manufacturer', 'hotchocolate manufacturer', 'burntumber manufacturer', 'drinkingchocolate manufacturer']
church member	['church appendage', 'churchbuilding member', 'churchservice member', 'Christianchurch member', 'church fellowmember', 'church penis', 'church extremity']
coffee break	['coffee stop', 'coffee go', 'coffee check', 'coffee part', 'coffee give', 'coffee better', 'coffee collapse']
coffee plantation	['coffee Plantation', 'java plantation', 'chocolate plantation', 'coffee grove', 'coffee orchard', 'coffeetree plantation', 'burntumber plantation']
college career	['college calling', 'college vocation', 'college lifehistory']
colony leaders	['Colony leaders', 'settlement leaders', 'colony leader', 'colony leadership', 'dependency leaders', 'colony lossleader', 'colony drawingcard']
color television	['color tv', 'color TV', 'color video', 'colour television', 'distort television', 'coloration television', 'colouring television']
column design	['editorial design', 'tower design', 'pillar design', 'column figure', 'column project', 'column aim', 'column pattern']
community radio	['community wireless', 'community tuner', 'bioticcommunity radio', 'communityofinterests radio', 'residentialarea radio', 'residentialdistrict radio', 'community receivingset']
competition organizers	['contest organizers', 'competition organiser', 'competition organizer', 'competition PDA', 'rivalry organizers', 'competitor organizers', 'challenger organizers']
computer network	['computer web', 'computer net', 'computer mesh', 'calculator network', 'estimator network', 'computingdevice network', 'electroniccomputer network']
computer simulation	['computer model', 'computer pretending', 'calculator simulation', 'estimator simulation', 'computingdevice simulation', 'electroniccomputer simulation', 'informationprocessingsystem simulation']
concentration requirements	['density requirements', 'concentration requirement', 'concentration necessary', 'concentration prerequisite', 'concentration essential', 'absorption requirements', 'tightness requirements']
construction duty	['building duty', 'construction obligation', 'construction responsibility', 'expression duty', 'structure duty', 'mentalsynthesis duty', 'grammaticalconstruction duty']
corner piece	['corner while', 'corner part', 'corner man', 'box piece', 'corner pick', 'tree piece', 'corner bit']
country mountain	['area mountain', 'land mountain', 'state mountain', 'country deal', 'country pot', 'country lot', 'country mount']
course format	['feed format', 'line format', 'class format', 'form format', 'path format', 'row format', 'track format']
crime scene	['crime view', 'crime picture', 'crime fit', 'crime aspect', 'crime setting', 'crime shot', 'offense scene']
crusader lord	['Crusader lord', 'crusader Lord', 'crusader Almighty', 'crusader Creator', 'reformer lord', 'crusader master', 'socialreformer lord']
cut flowers	['cut flower', 'cutting flowers', 'cut prime', 'cut flush', 'cut peak', 'trim flowers', 'track flowers']
data analysis	['information analysis', 'datum analysis', 'datapoint analysis', 'data psychoanalysis', 'data analyticthinking', 'data depthpsychology']
death squad	['Death squad', 'last squad', 'death team', 'end squad', 'demise squad', 'expiry squad', 'dying squad']
degree name	['stage name', 'level name', 'point name', 'grade name', 'degree list', 'degree key', 'degree make']
depression study	['depression read', 'Depression study', 'depression learn', 'depression take', 'low study', 'depression survey', 'depression work']
design details	['plan details', 'project details', 'design item', 'design point', 'design detail', 'pattern details', 'innovation details']
development needs	['growing needs', 'development take', 'development need', 'development motivation', 'growth needs', 'development want', 'development ask']
development scheme	['development strategy', 'development system', 'growth scheme', 'development outline', 'development schema', 'growing scheme', 'evolution scheme']
director credit	['manager credit', 'director reference', 'director recognition', 'director citation', 'director quotation', 'director mention', 'managingdirector credit']
disc clutch	['disk clutch', 'disc clutches', 'disc batch', 'disc hold', 'disc grip', 'saucer clutch', 'disc seize']
draft form	['draft class', 'outline form', 'draft work', 'drawing form', 'draft grade', 'draft phase', 'draft make']
education supervision	['training supervision', 'education oversight', 'teaching supervision', 'Education supervision', 'instruction supervision', 'education supervising', 'pedagogy supervision']
emitting diode	['emit diode', 'letout diode', 'breathe diode', 'giveout diode', 'utter diode', 'letloose diode', 'passoff diode']
event notification	['event notice', 'issue notification', 'case notification', 'result notification', 'event telling', 'effect notification', 'outcome notification']
family estate	['home estate', 'family land', 'house estate', 'category estate', 'class estate', 'household estate', 'family acres']
field use	['area use', 'subject use', 'study use', 'domain use', 'field practice', 'field function', 'field exercise']
flight lessons	['flying lessons', 'flight lesson', 'escape lessons', 'flight example', 'flight moral', 'flightofstairs lessons', 'flightofsteps lessons']
folk culture	['family culture', 'tribe culture', 'folks culture', 'folk polish', 'folk finish', 'folk civilization', 'kinfolk culture']
folk medicine	['family medicine', 'folk music', 'tribe medicine', 'folks medicine', 'kinfolk medicine', 'familyline medicine', 'ethnicmusic medicine']
folk singer	['folk Singer', 'family singer', 'folk vocalist', 'sept singer', 'tribe singer', 'folks singer', 'kinfolk singer']
following buildings	['following make', 'following building', 'following construction', 'following build', 'following progress', 'be buildings', 'following construct']
foot injury	['foot wound', 'foot hurt', 'hoof injury', 'foot trauma', 'foundation injury', 'legit injury', 'base injury']
freelance work	['freelance work', 'independent work', 'freelance employment', 'freelance make', 'freelance go', 'freelancer work', 'mercenary work']
glass box	['ice box', 'glass package', 'glass corner', 'chalk box', 'trash box', 'crank box', 'glass loge']
golf course	['golf track', 'golf run', 'golf path', 'golf line', 'golf class', 'golf feed', 'golf row']
government approval	['administration approval', 'governance approval', 'authorities approval', 'government approving', 'government blessing', 'governing approval', 'politics approval']
government funding	['government support', 'government fund', 'government financing', 'government backing', 'governance funding', 'administration funding', 'politics funding']
government permit	['government let', 'government permission', 'government license', 'government licence', 'government allow', 'authorities permit', 'administration permit']
government power	['government office', 'politics power', 'government might', 'government index', 'government force', 'administration power', 'governing power']
government sources	['government source', 'government reference', 'government informant', 'government author', 'administration sources', 'government beginning', 'government seed']
green color	['Green color', 'green colour', 'K color', 'common color', 'green gloss', 'green tinge', 'greenish color']
ground water	['soil water', 'land water', 'earth water', 'found water', 'base water', 'background water', 'primer water']
heart muscle	['eye muscle', 'nerve muscle', 'core muscle', 'meat muscle', 'pump muscle', 'tenderness muscle', 'center muscle']
honor guard	['honour guard', 'honor defend', 'honor hold', 'honor ward', 'honor safety', 'observe guard', 'award guard']
horse trials	['horse run', 'horse trial', 'horse test', 'knight trials', 'horse tryout', 'horse tribulation', 'Equuscaballus trials']
house painter	['sign painter', 'house cougar', 'home painter', 'theatre painter', 'house puma', 'house panther', 'family painter']
house plants	['house set', 'home plants', 'house plant', 'house institute', 'house works', 'house found', 'household plants']
ice age	['ICE age', 'glass age', 'ice years', 'frost age', 'frosting age', 'crank age', 'chalk age']
icon artwork	['icon art', 'icon graphics', 'image artwork', 'picture artwork', 'ikon artwork', 'icon nontextualmatter']
index finger	['index thumb', 'index feel', 'power finger', 'indicator finger', 'index digit', 'forefinger finger', 'exponent finger']
input box	['comment box', 'input package', 'remark box', 'stimulus box', 'stimulation box', 'stimulant box', 'input corner']
instruction set	['instruction Set', 'command set', 'direction set', 'statement set', 'education set', 'instruction do', 'teaching set']
instrument maker	['instrument Maker', 'tool maker', 'instrument manufacturer', 'instrument Divine', 'instrument Lord', 'instrument Creator', 'pawn maker']
lab explosion	['laboratory explosion', 'sciencelab explosion', 'researchlaboratory explosion', 'researchlab explosion', 'sciencelaboratory explosion', 'lab detonation', 'lab burst']
land mass	['Land mass', 'land Mass', 'land lot', 'land deal', 'land people', 'land masses', 'land mountain']
language acquisition	['language learning', 'language skill', 'speech acquisition', 'language attainment', 'terminology acquisition', 'words acquisition', 'language accomplishment']
language contact	['language link', 'words contact', 'speech contact', 'lyric contact', 'terminology contact', 'language liaison', 'language meet']
language versions	['language translation', 'language version', 'language interpretation', 'language edition', 'language reading', 'language variation', 'language variant']
lecture notes	['talk notes', 'lecture note', 'speech notes', 'lecture mark', 'lecture bill', 'lecture notice', 'lecture distinction']
library section	['library department', 'library part', 'library division', 'library segment', 'library subdivision', 'programlibrary section', 'subroutinelibrary section']
life jacket	['life cap', 'biography jacket', 'life crown', 'spirit jacket', 'lifetime jacket', 'lifetime jacket', 'living jacket']
liquor shop	['liquor store', 'spirits shop', 'liquor sponsor', 'booze shop', 'liquor rat', 'strongdrink shop', 'potliquor shop']
lyrics detail	['words detail', 'lyrics point', 'language detail', 'lyrics item', 'lyric detail', 'lyricpoem detail', 'lyrics particular']
map elements	['function elements', 'map element', 'map component', 'map constituent', 'represent elements', 'mapping elements', 'map ingredient']
maximum sensitivity	['utmost sensitivity', 'maximal sensitivity', 'uttermost sensitivity', 'maximum sensibility', 'maximum sensitiveness', 'upperlimit sensitivity', 'levelbest sensitivity']
member nations	['member state', 'member country', 'member Nation', 'member nation', 'member land', 'member commonwealth', 'fellowmember nations']
mouth movements	['mouth campaign', 'mouth move', 'mouth movement', 'lip movements', 'mouth cause', 'mouth front', 'mouth drive']
network data	['network information', 'web data', 'net data', 'mesh data', 'meshwork data', 'meshing data', 'network datum']
news source	['news reference', 'news author', 'word source', 'intelligence source', 'news seed', 'news beginning', 'news root']
nightclub goer	['club goer', 'cabaret goer', 'nightspot goer', 'nightclub leaver', 'nightclub departer']
north bank	['Union bank', 'North bank', 'N bank', 'north cant', 'north trust', 'north deposit', 'north rely']
numerical calculations	['mathematical calculations', 'numerical computation', 'numerical computing', 'numerical calculation', 'numeric calculations', 'numerical reckoning', 'numeral calculations']
ocean floor	['sea floor', 'ocean level', 'ocean deck', 'ocean story', 'ocean base', 'ocean knockdown', 'ocean dump']
oil company	['petroleum company', 'oil party', 'oil society', 'oil companion', 'oil fellowship', 'crude company', 'oil troupe']
oil storage	['petroleum storage', 'oil depot', 'oil store', 'oil memory', 'crude storage', 'oil storehouse', 'fossiloil storage']
open market	['open marketplace', 'open marketplace', 'clear market', 'openair market', 'spread market', 'give market', 'subject market']
opposition players	['enemy players', 'opponent players', 'Opposition players', 'opposition player', 'opposite players', 'foe players', 'resistance players']
output information	['production information', 'output data', 'yield information', 'output info', 'turnout information', 'output entropy', 'outturn information']
pagan family	['ethnic family', 'pagan home', 'pagan folk', 'pagan category', 'gentile family', 'pagan household', 'heathen family']
pagan people	['ethnic people', 'heathen people', 'gentile people', 'infidel people', 'pagan mass', 'pagan masses', 'heathenish people']
pain killer	['pain slayer', 'trouble killer', 'hurt killer', 'painsensation killer', 'annoyance killer', 'hurting killer', 'nuisance killer']
pamphlet form	['booklet form', 'folder form', 'brochure form', 'tract form', 'leaflet form', 'pamphlet build', 'pamphlet make']
paper card	['report card', 'paper board', 'paper poster', 'paper bill', 'theme card', 'paper notice', 'paper menu']
party list	['company list', 'party name', 'party number', 'party listing', 'party leaning', 'party heel', 'party lean']
pashtun tribe	['Pashtun tribe', 'pashtun clan', 'Pathan tribe', 'Pushtun tribe', 'pashtun folk', 'Pashtoon tribe', 'pashtun kindred']
peace settlement	['peace village', 'peace resolution', 'peace colony', 'serenity settlement', 'peace closure', 'peace colonisation', 'peaceofmind settlement']
people flock	['people deal', 'people mountain', 'people pot', 'people mess', 'people cluster', 'people plenty', 'people lot']
period laws	['stop laws', 'period law', 'period police', 'period Laws', 'point laws', 'flow laws', 'period Torah']
petroleum product	['oil product', 'petroleum production', 'crude product', 'petroleum merchandise', 'fossiloil product', 'crudeoil product', 'rockoil product']
phone call	['phone Call', 'phone address', 'telephone call', 'phone phone', 'call call', 'phone ring', 'phone name']
picnic lunch	['picnic luncheon', 'outing lunch', 'picnic tiffin', 'breeze lunch', 'picnic dejeuner', 'pushover lunch', 'snap lunch']
picture elements	['video elements', 'picture element', 'image elements', 'project elements', 'see elements', 'photo elements', 'film elements']
pipe system	['piping system', 'tube system', 'pipe arrangement', 'pipework system', 'pipe scheme', 'shrill system', 'shriek system']
plane spotter	['plane watch', 'plane finder', 'airplane spotter', 'plane lookout', 'plane sentry', 'plane scout', 'plane picket']
player images	['player see', 'player image', 'player double', 'player project', 'player range', 'player picture', 'player figure']
playing field	['playing area', 'work field', 'play field', 'playing battlefield', 'run field', 'bet field', 'playing arena']
playing time	['run time', 'play time', 'work time', 'meet time', 'act time', 'represent time', 'toy time']
plot structure	['game structure', 'plot construction', 'diagram structure', 'patch structure', 'plat structure', 'plotofground structure', 'secretplan structure']
pool facility	['pool installation', 'pond facility', 'syndicate facility', 'pool readiness', 'consortium facility', 'kitty facility', 'pocketbilliards facility']
pornography industry	['porn industry', 'porno industry', 'smut industry', 'erotica industry', 'pornography manufacture', 'pornography diligence', 'pornography industriousness']
potato peeler	['spud peeler', 'tater peeler', 'murphy peeler', 'Solanumtuberosum peeler', 'whitepotatovine peeler', 'Irishpotato peeler', 'whitepotato peeler']
presentation area	['display area', 'demonstration area', 'introduction area', 'intro area', 'presentation country', 'presentation domain', 'presentation field']
pressure difference	['force difference', 'press difference', 'pressure deviation', 'pressure conflict', 'blackjack difference', 'pressure remainder', 'insistence difference']
price hike	['Price hike', 'price rise', 'toll hike', 'price raise', 'price boost', 'cost hike', 'price hiking']
price increase	['Price increase', 'price growth', 'cost increase', 'damage increase', 'price increment', 'toll increase', 'price gain']
processor utilization	['CPU utilization', 'CPU utilization', 'processor usage', 'processor use', 'processor utilisation', 'processor employment', 'mainframe utilization']
product range	['product image', 'product order', 'product rate', 'product browse', 'product roll', 'product array', 'production range']
property investment	['property investing', 'place investment', 'holding investment', 'dimension investment', 'attribute investment', 'property investiture', 'belongings investment']
publishing effort	['publishing try', 'print effort', 'publication effort', 'publishing movement', 'publishing endeavor', 'release effort', 'publishing campaign']
punk band	['cheap band', 'tough band', 'punk set', 'punkrock band', 'bum band', 'hood band', 'cheesy band']
punk friend	['hood friend', 'tough friend', 'cheap friend', 'punk Friend', 'thug friend', 'bum friend', 'hoodlum friend']
radio program	['radio broadcast', 'radio programme', 'radio platform', 'tuner program', 'wireless program', 'radio plan', 'radio curriculum']
railway commission	['railroad commission', 'railway committee', 'railway mission', 'railway charge', 'railway commissioning', 'railway direction', 'railroadtrack commission']
railway construction	['railroad construction', 'railway building', 'railway structure', 'railway expression', 'railroadtrack construction', 'railwaysystem construction', 'railroadline construction']
railway police	['railroad police', 'railway law', 'railway patrol', 'railroadtrack police', 'railwaysystem police', 'railroadline police', 'railwayline police']
recording location	['enter location', 'show location', 'register location', 'record location', 'read location', 'transcription location', 'tape location']
reference number	['reference list', 'character number', 'reference count', 'source number', 'extension number', 'address number', 'citation number']
research work	['research study', 'research process', 'research employment', 'search work', 'research make', 'research act', 'research go']
resistance movements	['resistance movement', 'opposition movements', 'resistance front', 'resistance trend', 'underground movements', 'resistance campaign', 'resistance effort']
return flight	['take flight', 'return escape', 'fall flight', 'give flight', 'issue flight', 'pass flight', 'refund flight']
ringing phone	['phone phone', 'call phone', 'telephone phone', 'band phone', 'ringing sound', 'ring phone', 'ringing telephone']
risk factor	['risk gene', 'hazard factor', 'risk element', 'danger factor', 'risk component', 'chance factor', 'risk broker']
root cause	['origin cause', 'root make', 'root do', 'root have', 'root drive', 'root get', 'base cause']
root structure	['theme structure', 'solution structure', 'base structure', 'source structure', 'origin structure', 'stem structure', 'root construction']
safety arrangements	['safety system', 'safety organization', 'safety organisation', 'safety agreement', 'safety transcription', 'safety placement', 'safety arrangement']
safety implications	['safety significance', 'safety import', 'safety implication', 'safe implications', 'safety deduction', 'rubber implications', 'basehit implications']
safety improvements	['safety improvement', 'safety advance', 'guard improvements', 'refuge improvements', 'safety betterment', 'safe improvements', 'rubber improvements']
scholarship recipient	['learning recipient', 'scholarship receiver', 'encyclopaedism recipient', 'learnedness recipient', 'eruditeness recipient', 'erudition recipient', 'encyclopedism recipient']
school clothes	['school dress', 'school apparel', 'school invest', 'school robe', 'train clothes', 'school tog', 'school garb']
school contract	['school get', 'school sign', 'school press', 'school take', 'school signup', 'train contract', 'school cut']
school district	['school zone', 'school dominion', 'train district', 'schoolhouse district', 'school territory', 'schooling district', 'educate district']
school mates	['school match', 'school partner', 'school mate', 'school twin', 'school mat', 'school teammate', 'school fellow']
school scholarship	['school learning', 'school erudition', 'schoolday scholarship', 'schooling scholarship', 'shoal scholarship', 'cultivate scholarship', 'schooltime scholarship']
secured installation	['secure installation', 'plug installation', 'guarantee installation', 'secured facility', 'fix installation', 'ensure installation', 'secured installment']
security agreements	['security agreement', 'security understanding', 'protection agreements', 'security arrangement', 'security accord', 'security correspondence', 'security concord']
security guard	['security safety', 'security precaution', 'protection guard', 'security safeguard', 'security hold', 'security defend', 'security ward']
security matters	['security issue', 'security subject', 'security topic', 'protection matters', 'security matter', 'security thing', 'security count']
security reasons	['security grounds', 'security reason', 'security understanding', 'security ground', 'protection reasons', 'security cause', 'certificate reasons']
security registration	['protection registration', 'certificate registration', 'security enrollment', 'security adjustment', 'security enrolment', 'surety registration', 'securitymeasure registration']
security situation	['security site', 'security office', 'security post', 'security place', 'security position', 'security spot', 'protection situation']
semiconductor manufacturer	['semiconductor maker', 'semiconductor producer', 'semiconductorunit manufacturer', 'semiconductordevice manufacturer', 'semiconductingmaterial manufacturer', 'semiconductor manufacturingbusiness']
service area	['Service area', 'service domain', 'help area', 'service field', 'serving area', 'service region', 'service arena']
sex education	['sex Education', 'sexuality education', 'gender education', 'sex instruction', 'sex teaching', 'excite education', 'sex training']
shift work	['change work', 'transfer work', 'shift function', 'break work', 'transformation work', 'shifting work', 'teddy work']
short notice	['short note', 'little notice', 'short comment', 'short remark', 'short bill', 'short card', 'suddenly notice']
short story	['short history', 'little story', 'short report', 'short account', 'short narrative', 'short tale', 'dead story']
side pocket	['side pouch', 'side bag', 'English pocket', 'face pocket', 'side scoop', 'side sac', 'position pocket']
side role	['side part', 'side use', 'position role', 'side office', 'side character', 'side function', 'English role']
silver piece	['silver while', 'silver part', 'silver man', 'silver pick', 'silver slice', 'silver bit', 'silver composition']
simulation noise	['model noise', 'simulation randomness', 'simulation interference', 'simulation stochasticity', 'computersimulation noise', 'feigning noise', 'pretence noise']
singing group	['talk group', 'sing group', 'whistle group', 'peach group', 'telling group', 'blab group', 'babble group']
site replacements	['site switch', 'site replacement', 'site replacing', 'site alternate', 'site renewal', 'site substitute', 'site substitution']
skin care	['skin like', 'skin concern', 'hide care', 'skin maintenance', 'skin attention', 'skin aid', 'skin handle']
skin cell	['hide cell', 'skin cellphone', 'pare cell', 'struggle cell', 'shinny cell', 'pelt cell', 'scrape cell']
software vendor	['software seller', 'package vendor', 'software marketer', 'software vender', 'softwarepackage vendor', 'computersoftware vendor', 'softwaresystem vendor']
soil surface	['land surface', 'ground surface', 'dirt surface', 'dirty surface', 'grease surface', 'soil open', 'stain surface']
sorcery stories	['sorcery tale', 'sorcery level', 'sorcery story', 'sorcery history', 'sorcery narrative', 'necromancy stories', 'blackmagic stories']
southeast part	['southeast region', 'southeast division', 'southeastern part', 'SE part', 'Southeast part', 'southeast portion', 'southeast section']
space theme	['space report', 'space base', 'place theme', 'space stem', 'space subject', 'blank theme', 'space paper']
spoken language	['spoken words', 'talk language', 'address language', 'speak language', 'spoken speech', 'mouth language', 'spoken lyric']
sports day	['fun day', 'sports Day', 'play day', 'sport day', 'sportsman day', 'feature day', 'athletics day']
spring water	['give water', 'fountain water', 'form water', 'bound water', 'jump water', 'bounce water', 'outflow water']
stamp collection	['stamp collecting', 'cast collection', 'seal collection', 'stamp appeal', 'boss collection', 'postage collection', 'tender collection']
state funds	['State funds', 'state fund', 'state store', 'state finances', 'state stock', 'country funds', 'province funds']
state radio	['country radio', 'State radio', 'nation radio', 'express radio', 'say radio', 'state wireless', 'land radio']
steel tube	['steel pipe', 'steel tubing', 'steel underground', 'brand tube', 'steel metro', 'steel subway', 'blade tube']
stimulant medication	['stimulation medication', 'stimulant medicine', 'stimulating medication', 'stimulant medicament', 'excitant medication', 'stimulus medication', 'input medication']
stock company	['store company', 'line company', 'fund company', 'standard company', 'livestock company', 'inventory company', 'origin company']
stone tablet	['Stone tablet', 'stone pad', 'stone tab', 'rock tablet', 'stone pill', 'stone lozenge', 'HarlanFStone tablet']
stroke cases	['accident cases', 'stroke type', 'shot cases', 'stroke case', 'stroke event', 'stroke font', 'stroke cause']
student film	['student movie', 'student take', 'student cinema', 'scholar film', 'student picture', 'student pic', 'student shoot']
substance abuse	['substance misuse', 'content abuse', 'center abuse', 'essence abuse', 'means abuse', 'message abuse', 'heart abuse']
sun time	['Sun time', 'Sunday time', 'sun clock', 'sun clip', 'sunshine time', 'sunlight time', 'sun meter']
target cell	['direct cell', 'object cell', 'place cell', 'aim cell', 'point cell', 'mark cell', 'objective cell']
target language	['target words', 'object language', 'direct language', 'point language', 'mark language', 'place language', 'objective language']
taxation regulation	['tax regulation', 'revenue regulation', 'taxation rule', 'taxation ordinance', 'revenueenhancement regulation', 'taxincome regulation', 'taxrevenue regulation']
teaching career	['education career', 'instruction career', 'learn career', 'teach career', 'pedagogy career', 'teaching vocation', 'teaching calling']
teaching position	['teaching post', 'teaching office', 'education position', 'teaching situation', 'teaching view', 'teaching status', 'teaching placement']
television programme	['television program', 'television broadcast', 'tv programme', 'TV programme', 'video programme', 'television plan', 'television curriculum']
television shows	['tv shows', 'TV shows', 'television show', 'video shows', 'television read', 'television appearance', 'television picture']
time zone	['time district', 'sentence zone', 'meter zone', 'clock zone', 'time partition', 'metre zone', 'clip zone']
toilet paper	['bathroom paper', 'can paper', 'potty paper', 'pot paper', 'john paper', 'toilette paper', 'lavatory paper']
track selection	['course selection', 'path selection', 'track option', 'tag selection', 'dog selection', 'cover selection', 'track pick']
trade area	['trade country', 'craft area', 'swap area', 'sell area', 'deal area', 'trade arena', 'merchandise area']
train interior	['train home', 'school interior', 'condition interior', 'train inside', 'train Interior', 'train national', 'direct interior']
tram system	['trolley system', 'streetcar system', 'tramway system', 'tram scheme', 'tramcar system', 'ropeway system', 'trolleycar system']
translation memory	['translation storage', 'version memory', 'rendering memory', 'translation store', 'transformation memory', 'displacement memory', 'translation remembering']
translations date	['version date', 'translations see', 'translation date', 'transformation date', 'rendering date', 'displacement date', 'interlingualrendition date']
transmission shaft	['transmission tool', 'transmission beam', 'transmitting shaft', 'transmission peter', 'transmission screw', 'transmission shot', 'transmission dick']
trust issues	['faith issues', 'trust return', 'trust issue', 'confidence issues', 'trust take', 'bank issues', 'trust event']
turquoise color	['aqua color', 'turquoise colour', 'aquamarine color', 'turquoise gloss', 'turquoise coloring', 'turquoise coloration', 'turquoise tinge']
twentieth century	['20th century', 'twentieth C', 'twentieth hundred', 'twentieth 100', 'twentieth oneC']
twin sons	['Twin sons', 'twin boy', 'twin son', 'twin Son', 'parallel sons', 'mate sons', 'twin Logos']
video circuit	['video tour', 'TV circuit', 'video circle', 'television circuit', 'video lap', 'picture circuit', 'videorecording circuit']
video clip	['video magazine', 'video time', 'TV clip', 'video crop', 'video trim', 'picture clip', 'television clip']
video club	['TV club', 'video order', 'picture club', 'video nine', 'television club', 'video society', 'video guild']
video tape	['video record', 'video taping', 'TV tape', 'video videotape', 'television tape', 'picture tape', 'video taperecording']
village community	['Village community', 'settlement community', 'hamlet community', 'GreenwichVillage community', 'smalltown community', 'village bioticcommunity', 'village communityofinterests']
visual arts	['visual art', 'visual graphics', 'visual artwork', 'visual artistry', 'visual prowess', 'ocular arts', 'optic arts']
volunteer army	['Volunteer army', 'volunteer Army', 'volunteer USA', 'voluntary army', 'unpaid army', 'offer army', 'unpaidworker army']
war effort	['war movement', 'war campaign', 'war drive', 'war cause', 'war try', 'war feat', 'war attempt']
water molecule	['water particle', 'H2O molecule', 'water atom', 'water mote', 'water speck', 'weewee molecule', 'bodyofwater molecule']
water resources	['water resource', 'H2O resources', 'water imagination', 'urine resources', 'weewee resources', 'bodyofwater resources', 'pee resources']
water sports	['water sport', 'water feature', 'water play', 'water sportsman', 'water fun', 'H2O sports', 'water variation']
water transfer	['water transportation', 'water transport', 'water change', 'water remove', 'water channel', 'water conveyance', 'water shift']
wear clothes	['clothing clothes', 'wearing clothes', 'wear apparel', 'wear dress', 'bear clothes', 'wearable clothes', 'wear garment']
web page	['web Page', 'net page', 'WWW page', 'network page', 'entanglement page', 'vane page', 'WorldWideWeb page']
web site	['network site', 'net site', 'WWW site', 'web website', 'web website', 'web place', 'web locate']
west part	['west region', 'west division', 'West part', 'west office', 'west section', 'W part', 'west divide']
wind direction	['wind commission', 'winding direction', 'wind way', 'wind charge', 'lead direction', 'wind steering', 'wind management']
women dress	['women do', 'women apparel', 'women clothes', 'women set', 'woman dress', 'women garment', 'women clip']
word order	['Book order', 'Word order', 'word Order', 'news order', 'word tell', 'password order', 'word say']
work colleague	['work fellow', 'work coworker', 'workplace colleague', 'bring colleague', 'form colleague', 'run colleague', 'make colleague']
world view	['world watch', 'public view', 'world see', 'world opinion', 'global view', 'Earth view', 'earth view']
wrestling fan	['worm fan', 'twist fan', 'grappling fan', 'rassling fan', 'wrestling buff', 'wrestling lover', 'wriggle fan']
wrestling program	['worm program', 'wrestling broadcast', 'wrestling platform', 'twist program', 'grappling program', 'wrestling curriculum', 'wrestling plan']
youth movement	['youth campaign', 'youth front', 'youth move', 'young movement', 'youth cause', 'youth drive', 'youth trend']
